007	female
01225591445	male
.11	male
1234	male
147184	male
19	unknown
22mora22	female
2esh2esh	male
2k	male
2os2os	unknown
3abdelsattar	unknown
3abdurra7man	male
3abodi	male
3absalam	male
3adoul	unknown
3AFRETAT	male
3agamawy	male
3agaty	unknown
3aiez-awsaaaal	male
3ala	female
3ala2	female
3alama	male
3ali	male
3alolo	male
3am	male
3am_joe	unknown
3asafrway	male
3asalyaa	female
3asawy	male
3asfour89	male
3bdelrahman	male
3bdu	male
3bnasser	male
3boli	female
3ebooo	female
3eloa	female
3ezo9991	male
3ezzo	female
3idovich	male
3issa25	male
3la2	male
3Li	male
3lwa	female
3m	male
3mera	female
3moora	female
3morawi	female
3okashaaa	female
3olwa	female
3omda	female
3omda21	male
3omdaaaaz	female
3omdah	female
3oraby	unknown
3s4a	female
3shma	female
3shoush	female
3smoot	female
3umaar	male
3yad	male
3zat	male
3zouz	male
4a	female
4fun14	male
4Hs	male
5alilo	female
5'o5'a	female
7abashyy	male
7abeba	female
7afez	male
7ala	female
7amada	male
7amdiii	male
7amed	male
7ammad	male
7amo	male
7amza	male
7anafy	unknown
7anan	unknown
7araaam	male
7arankashaya	male
7arfoush	male
7arouni	male
7asan	male
7asnaa	female
7assanof	male
7atem	male
7azem	male
7eddo	male
7eesh	male
7egazofitsh	male
7ego	unknown
7eska	female
7igab	female
7modeee	female
7oda	female
7onkololo	male
7ooza85	male
7osam	male
7oss	male
7oToB	male
7raam	male
86	male
a	unknown
A	unknown
A.	unknown
A2M	male
a.3emo	female
a7ma6esho	male
a7mad	male
a7maD	male
A7mad	male
a7mds3d	male
a7med	male
A7med	male
a7med.3ly	male
a7med7ossien	male
A7med.alashqar	male
a7medrushdy	male
A7mos	male
aa	female
AA	female
AAA	female
aaamin	male
aabady	unknown
a-abdelfattah	unknown
A.Abdoun	male
AAbdurrahman	male
aadawy	male
a.adel07	male
Aadly	unknown
Aaed	male
aaelaty	unknown
aagamel	female
aahmedislam	male
Aal	male
aalaahamouda	male
aaleem	male
aarehim	male
Aasem	male
a_asfahany	male
A.Ashraf	male
aassil67	male
aatrees	female
ab	male
Ababykangaroo	male
abaghdadi	male
Abanob	male
Abanobgamal1	male
abanoub	male
A.batroukha	female
abbassi	male
abd	male
Abd	male
Abd%20El%20Rahman%20Hosny	male
Abd84	male
abdalla	male
Abdalla	male
Abdalla%20Mohamed	male
abdallah	male
Abdallah	male
abdallah2010	male
abdallahmokhtar	male
abdalmagid	unknown
abdeen28	male
abdeinoo	male
abdel	male
Abdel	male
abdelawal	unknown
Abdelazim	male
Abdelaziz	male
Abdelbaky	unknown
abdelfattah	male
abdelgalel	male
Abdelhady	male
Abdelhameed	male
abdelhamid	male
Abdelhamid	male
abdelkarimkk	unknown
Abdelmaguid	male
Abdelmaksod	male
Abdelmeguid	male
Abdelmonem	unknown
abdelrahman	male
Abdelrahman	male
AbdelRahman	male
abdelrahman1m	unknown
abdelrahman94	unknown
abdelrahmano	unknown
abdelraouf	male
abdelrauf	unknown
Abdelrheem	male
abdelrhman	male
abdelrhman.basha	female
abdelsalam.eng	male
abdo	male
Abdo	male
Abdo1	male
abdobiko	male
abdoelhamad	unknown
abdoelsona	male
abdohelal	male
abdoooo	male
AbdoTheEagle	male
abdrahman	male
Abdulaziz.Abdulbaset	male
Abdulhadi	male
abdullah	male
Abdullah	male
Abdullatif	male
abdulrahman	male
Abdulrahman	male
Abdulrhman	male
Abed	male
abedwehy	male
abeer	female
Abeer	female
Abeya	female
abico2005	male
abidal	male
ab_kad	male
Abla	female
Abmedabdelaziz	male
abo	male
Abo	male
ABO	male
abo7maid	male
AboAdam	male
abo-ali	male
aboali_m	male
AboAlusr	male
AboAly	male
Abo_Amir	male
AboAsserElkholy	unknown
aboda	female
AboDeeDee	male
aboeldnagel	male
Abo-Hamad	unknown
abohamza	male
AboHanafy	male
aboishak	male
abo_malk	male
abomido	unknown
abomota	female
AboMousa	unknown
abonehad	male
Aboodooz	male
Aboody	male
aboomar	male
AboOmar8	male
abooo	male
aboshadayda	female
Abosofian	male
abou	male
Abou	male
Abou7seen	unknown
abouds05	male
Abouel	unknown
aboueldahab	unknown
abouelhassan	male
abouelmaggd	male
Abouelsaoud	male
AboulAzm	male
Aboulezz	male
AboulMasabe7	unknown
aboulwafa	female
aboushosho	male
aboyaseen	male
aboyoussef	male
abozeyad	male
abseldaym	male
abu	male
Abu	male
AbuAkram	male
Abubakr	male
abudeif72	female
abul3araby	unknown
abulezz	male
abulleil	male
Abulmagd	male
AbuSalah	male
abutamem	male
Acc.Sameh	male
aceofthespades	female
A.D	unknown
adam	male
Adam	male
adamsamir	male
adarrag	unknown
Addoula	female
Adeeb	male
adel	male
Adel	male
adel69	male
adel77	male
a.desouky	female
adham	male
Adham	male
Adham.Adam	male
adhamghaly	male
adhادهمamdaoc	male
Adi84	male
a_diaa	female
Adl	male
Adly%20Hasan	male
Adm-es	female
Adnanfr1	male
ADom4	male
adoo	male
adoola	female
adoul	unknown
ADRYANO	male
adxff	male
aek	male
A-EL	female
aelaskary	male
aelfas	male
aelgamal	male
a.elkassaby	unknown
a.elkeiy	unknown
a.elnahhas	unknown
Aelrakeeb	female
aelrobegy	male
aelsawi	female
aelsherei	male
aelsherif77	male
aemadmad	male
AF	male
afandina	female
afathy3	unknown
AFeqi	female
Afif.a	unknown
afify47	unknown
Afioooo	unknown
afsawaf	unknown
aftksat	male
Agad	male
agamal1	male
AGemmy	male
aghanem	unknown
agody1999	male
agomaa77	male
AGouda	male
Ah	male
A.H	unknown
ahabhady	male
A.Halim	male
a.hamza	male
ahany90	male
ahatef	female
A.Hawary	male
ah.aziz	male
ahdmedhat	male
A.Heiba	female
A.Hellal	male
A.hena	female
A.Hendy	unknown
Ah.Ezz	male
ahkhairy	unknown
ahlawy	female
ahlawy5	female
a.h.m.	male
ahm123ed	male
ahm507	male
ahmad	male
Ahmad	male
ahmad1985	male
Ahmad%20Hesham	male
ahmad_abdallah	male
AhmadAladin	male
ahmadbahey	male
AhmadBelal	male
ahmadeeta	male
ahmadeldabi	male
Ahmad.Elnaggar	male
Ahmadfathi	male
ahmadgalal	male
ahmadgalal74	male
ahmad.halim	male
Ahmad_Hussain	male
Ahmadiesel	male
ahmadimam	male
Ahmad_Karama	male
AhmadKhater	male
ahmad-maher	male
ahmadoz	male
ahmadsaleh	unknown
AhmadSMira	female
ahmady_	male
ahmd	male
ahmd83	male
ahmd.afifi	male
ahmdalaa	male
Ahmddomar	male
ahmdkrm	male
ahmed	male
aHmEd	male
Ahmed	male
AHMED	male
ahmed0shahin	male
ahmed1189	male
Ahmed%20Abd%20Rb%20Elnby	male
Ahmed%20Abo%20Eid	male
Ahmed%20Alaa	male
Ahmed%20Amer%20Abo%20Al-Khair	male
Ahmed%20Ashraf	male
Ahmed%20Auf	male
Ahmed%20Bendary	male
Ahmed%20Ebeid	male
Ahmed%20El%20Khouly	male
Ahmed%20Elkhataby	male
Ahmed%20ElSharawy	male
Ahmed%20Fayez	male
Ahmed%20Hassan	male
Ahmed%20Hosny%20Midoo	male
Ahmed%20Ibrahim	male
Ahmed%20Korayem	male
ahmed%20L%20za3farany	male
Ahmed%20Mahmoud	male
Ahmed%20Mostafa	male
Ahmed%20Ragab	male
Ahmed%20Saker	male
Ahmed%20Sayed	male
Ahmed%20Shaheen	female
Ahmed%20Shebl	male
ahmed277	male
ahmed3aziz	male
ahmed4	male
Ahmed6867	male
ahmed75	male
ahmed777	male
ahmed78	male
ahmed81	male
ahmed9110	male
Ahmed926	male
Ahmed9591	male
ahmedabdelaal	male
ahmed.abdelaal	male
ahmedabdelallahmed	male
Ahmedabdelaziem	male
Ahmedabdelrazek	male
ahmedadel	male
ahmedadelnasser	male
ahmedali	male
ahmed.ali317	male
ahmed_allam	male
Ahmed.Amer101	male
ahmedamr14	male
ahmedaql	male
Ahmed_Arafa	male
Ahmed.Ashraf	male
ahmedassem82	male
ahmedatif	male
ahmedatiya	male
Ahmed_Ayman	male
ahmedbahgat00	male
ahmedbiko	male
ahmed_boly	male
ahmedcasper	male
Ahmeddawood	male
AhmedDawood	male
ahmed.dessouky	male
AhmedDr	male
ahmed.e	male
ahmed_eisa	male
ahmed.el	male
ahmedelabd	male
ahmedelbahey	male
ahmed.elbatta	male
Ahmed.Elghamry	male
ahmedello	male
ahmedelmola	male
AhmedElrabeaiy	male
ahmedelrawy	male
ahmed.elwakel	male
AhmedElZayat	male
ahmedemad87	male
ahmedesam	male
ahmed_Etemad	male
ahmedezz	male
ahmedezzat_6	male
ahmedezzo	male
ahmedfarag88	male
ahmed.farouk	unknown
ahmedfathi	male
AhmedFathi2364	male
ahmedfathy	male
ahmedfathyabbas	male
ahmedfikry79	male
ahmedfouda	male
ahmedgabr	male
Ahmed_gad	male
ahmedgad3	male
ahmed_gafi	male
ahmedgamal	male
ahmedgasser	male
ahmedgemy	male
ahmedguendi	male
ahmedhabib	male
ahmedhamdy	male
ahmedhamdyz	male
ahmedhamedtawfik	unknown
ahmedhassan	male
Ahmed.Hassanein	male
ahmedhatem1	male
ahmed_Hisham	male
ahmedhossam	male
ahmed.ibrahim82	male
ahmedido	male
ahmedino94	male
ahmedisaed	male
ahmedjoey10	male
Ahmedkady020	male
ahmedkandeel	male
ahmedkhalil	male
ahmedkhalil800	male
ahmedko21	male
ahmed.loai	male
ahmedmadkour	male
Ahmed.Magdi86	male
ahmedmamdouh	male
AhmedManooosh	male
ahmed.mashal	male
ahmedmekha	male
ahmedmkhaled	male
ahmedmohamedsherif	male
ahmedmoneeb	male
AhmedMoniem10	male
ahmed.mortada88	male
ahmed.mosalam	male
AhmedMostafa97	male
ahmedmostafaaa	male
AhmedNour	male
ahmednwar	male
AhmedOthman	male
Ahmed.ouda81	male
ahmedraafat	male
AhmedRafat	male
Ahmedragaei.25	male
ahmedreda	male
AhmedReda66	male
ahmedreda8311	male
ahmed.sabry.sakr	male
ahmedsaleh_pharme	male
Ahmedsamer	male
ahmedsamir197500	male
Ahmed.samir238	male
ahmedsamy	male
ahmedsamy19	male
Ahmedsayed	male
ahmed_sayed2014	male
ahmed_selim	male
ahmedserry	male
Ahmedsh	male
Ahmed.Shafei	male
Ahmedshams2030	male
Ahmed.Shawky	male
ahmedshebl	male
Ahmed_Sherif	male
ahmedsherifmoody	male
ahmedshobra	male
AhmedSmart	male
ahmedswesy	male
ahmed.taghian	male
ahmedtaha	male
AhmedTahaYasin	male
ahmed_talaat_miro	male
AhmedTawfik	unknown
ahmed_ussef	male
AhmedV	male
ahmedvenous	male
ahmed_ward	male
ahmedyasser	male
ahmed_yehia	male
Ahmedyehia	male
ahmedyusri	male
AhmedYZAB	male
ahmedzaater	male
ahmedzizoo	male
ahmehMohey	male
ah_m_osman	male
ahmsalem	male
A.Hussein	male
ahussein78	male
ahzaky	male
aia	female
AIA	female
aibrahim146	male
aidabadawy	female
aida.mourad	male
AIH	unknown
Air	male
aishay	unknown
aislah	male
AITharwat	male
Ajoo	male
AK	male
ak208	male
akafrawi	female
Akaissy	female
akandsg	female
akghoneim	male
A.khattab	male
akhdary	unknown
Akil	male
akinawy	male
akl.mohamed73	male
A.koriem	female
aKotby	male
akram	male
Akram	male
Akram.Amin	unknown
akramhoba	unknown
akrooom	male
Al	male
AL	male
Ala	female
alaa	male
Alaa	male
Alaaabo	male
alaaegypt	male
alaaelansary	unknown
AlaaEldenElmasry	male
AlaaElhosieny	male
AlaaFahmy	male
alaamagdy007	male
alaamarzouk	male
alaa_moh	male
Alaamohamed	male
alaanasr	unknown
alaanoor	female
aladdin11	male
Aladdinm	male
Aladin	male
alaround	male
a.latif	male
alaurahman	male
alawi660	male
Alayas	unknown
Alb	male
albadri	unknown
Albertinii	male
aldamasy85	male
alesh	male
alfred	male
Alfred%20Ashraf%20Farid%20Sobhy	male
Algaml	male
alhagrasy	male
alhassan	male
Alhefny	male
alhelb	male
ali	male
Ali	male
Ali138	male
alia	female
Alia	female
aliaa	female
Aliaa	female
Aliaa_altawy	unknown
aliakb	male
AliB	male
Ali_Bendary	male
alicio	male
aliel28	male
ali_elbeblawy	male
Ali.Elsherif	male
alien_3157	male
Ali.k	male
alimano	male
Alisherif	male
ali.tarek	male
Aliyah	female
Ali_yousrii	male
Ali_youssri	male
aljouhary	unknown
alkabeer	unknown
allam	male
Allam	male
allamahmed	male
Allamo	unknown
Almasry	unknown
Aloshi	unknown
Aloub	male
Alshafie	male
alshaimaa	unknown
Alsharawy	unknown
alshehabpop	male
Altima	female
alwi	male
aly	male
Aly	male
Aly777	unknown
Alya	female
Alyaa	female
alybasel.	unknown
alylee	female
Aly.sherif	male
alywally	unknown
alyzeineldin	male
Ama	female
amado	male
Amado84	male
A_Magdi	male
amagdy	male
a_maher92	female
A.mahmoud	male
Amaino	male
amal	female
Amal	female
amalanwar	unknown
amalemadeldin34	male
Amalgamal	male
amalnassar	unknown
Amal.sayed	male
A.Mamdouh	male
amani	female
amansour	male
amany	female
Amany	female
Amany%20Mohamed	male
amanyelsada	female
amanyfarahat	male
amanymob	male
AMAROK	male
amawgood	male
A.M.Badawy	male
ameen	male
Ameen	male
Ameer	male
ameera	female
AmeerBond	male
ameerohamed	male
amel	female
AMElbehery	female
amer	male
Amer	male
amer1018	male
AmerClio	male
amerekap	male
ameroby	male
amfathy	female
Amgad	male
AMGAD	male
Amgad8	female
amgad.kamel67	female
amgadmostafa	male
AMIG1992	female
amigo	female
Amii	female
Amiir	male
amimoet	female
amin	male
Amin	male
amin.alnagar	unknown
aminmono	female
aminooo	female
aminsaber71	female
amir	male
Amir	male
amir0711	female
Amir%20Kamel	male
Amir%20Philippe	male
amira	female
Amira	female
Amira257	female
AmirAbdelKader	male
amirak2012	female
amir.alabyd	female
amiraly	female
AmiraMohBarakat	unknown
amir_ghatas	female
amirhanywilliam	male
amir.helal	female
Amir_Mohamed	male
amirnagy	female
AmirWagih	female
amirzaher	male
Amjad	male
A.M.Khalaf	male
ammar	male
Ammar	male
Ammaryosrii	male
Amna	female
Amna.Afify	unknown
amnassar1.an	female
AMNgolf	female
amod	male
amohsen84	male
amooroo	male
Amooza	female
AmOrI	female
amorxxx	female
Amory	male
amostafa	male
A.mostafa	male
AMounir07	male
amousa	male
amouza	female
amr	male
aMr	male
Amr	male
AmR	male
AMR	male
amr1803	female
Amr_1907	male
Amr%20Abdel%20Moneim%20Mohamed	male
Amr%20Ali	male
Amr%20El%20Dsouky	male
Amr%20El%20Hag%20Ahmed	male
Amr%20Hendi	male
Amr%20Mohamed%20Allam	male
AMr%20WALLy'	unknown
Amr2266	male
amr77	male
Amr_911	male
amr.abdelhamid	male
AmrAbdelhamid	male
amraboelyazid	male
amradel	male
amr.adlly	male
amrahmed219	male
amrahmed91	male
amraly2013	female
amr_asma1328	male
amrdirector	male
amreid	male
amrelbadrawy	male
AmrElhamy	male
amrelkashef	female
Amr.Eltablawy	male
amresheta	female
Amrester	male
amrfahmy	male
Amrfawzyfawzy	male
AmrGaffar	male
AmrGawish	unknown
AmrHamza83	female
amr_hani	male
amr.hawatky	male
amrifky	male
amring	unknown
amrismail	unknown
Amrito	female
amr.kamaldsc	male
amrkarim83	female
Amrkasem	male
AmrKhaled	male
amrklo	male
AmrKouta	female
amrmaher	male
amrmbadr	male
amrmorsi	male
Amr_Morsy	male
AmRMoSolimaN	male
amrmostafa	male
amrmsh	male
amro	male
Amro	male
amro145	male
Amro988	male
amro_basset	unknown
Amroelfiky	male
amro.elnagar	male
Amrohady	male
amroki	male
amroooo	male
Amroush	male
Amrsaad	male
aMrSaMaHy	male
amrshams	unknown
amrshet	female
amr_shetia	female
amrswaify	male
amrszaki	male
amrvoda	female
Amrz8	male
amsalama	female
amsamy	male
amsksoud	unknown
AMTourky	female
AmyQuotb	female
Amyzzzzzz	female
ana	female
Ana	female
A.Nahas	male
anakhaledmedhat	male
anas	male
Anas	male
Anas%20Abu%20Sarhan	male
anasAbdelRahman	male
Anas-Nagati	female
anasr007	male
anasr1	male
anazouz	unknown
andoza	female
andre.valavanis	male
andrew	male
Andrew	male
andrewayman1	male
AndrewEmil	male
andrew.s.ezzat	unknown
andricoo	male
androlo	male
androw	male
Andy	male
Andy2588	male
anees	male
angela	female
angelchi56	male
Angi	female
Angouge	male
AnneHabib	male
anojasi	female
anonym	male
Anoooog	male
anoush	female
Ans00	unknown
answahdan	female
A_N_T_A_R	male
Anthony	male
antoni000	male
Antonious	male
antony	male
anwar	male
Anwar	male
A.O.ElGendy	unknown
AON	male
aothman99	male
AR	female
arabybasha	female
A.Raf3y	male
aragab	female
ARagheb	male
a.ragy	male
Arahzel	male
arashad1	male
araslan	male
Arch	male
arch.m.elhawary	unknown
areej	female
areej.zaki	unknown
Arizk78	male
Armandiz	male
armendonj	male
ARS	female
arsn91	male
Arwa	female
As3ad	male
As8118	female
asaa	female
Asaafan26r	male
asadekh	female
Asaeed81	male
asalia	female
asamak	female
asamir	male
ASamir10	male
Asamir_83	female
asarhan	male
asaroukh	male
a.sedik	male
aseerelme7war	male
asehs	female
aser	male
Aser	male
Asfahany	male
ash	female
Ash	female
ASH	female
ash18	female
ashemr	female
asherif1	female
ashkeef	female
ashoukry2013	female
Ashour	male
ashr00f	male
ashraf	male
Ashraf	male
Ashraf%20Elmorsy	male
Ashraf%20Rashad	male
Ashraf%20Tabl	male
ashraf222	male
ashraf676	male
ashraf92	male
AshrafBakir	male
Ashraf.elsabea	male
ashraffathy	male
Ashrakat	male
ashruf78	male
ashry	male
Ashry	male
Ashsk	female
asibrahim99	female
Asif	male
ask	male
a.s.k.13	female
askandarani	female
askandil	male
askarino	unknown
Asmaa	female
Asmaa%20Shaheen	female
asmaaelami	unknown
asmaaelbehairy	unknown
asmoaaaa	female
Asmouta	female
a.sob7y	male
asomas	male
assa	female
Assadsamy	male
assem	male
Assem	male
AsSeM	male
assem.abdeen	female
Assemelooo	unknown
asser	male
Asser	male
assermhassan	male
Asslan	male
Astlavista	female
asvision	female
at313	female
Ataa	female
atalaat1	unknown
atef	male
Atef	male
atef.alam1970	male
AtefBadr	male
Atefe	male
atharwat	male
ATK	male
atou7	male
atserag	male
atsh77	male
autowahba	female
AW	female
awa	female
awa2el7	male
Awab	male
Awad	male
awad-allah	male
Awaga	female
awaheed	male
awakil911	male
awdallah	male
awghali	male
Awny	male
awsam	male
Awwad	unknown
Ay	female
aya	female
Aya	female
Aya.A.A	female
AyaAbdelAal	male
AyaBertoo	male
AyaEhab	male
aya.eln	male
Ayah	female
ayahesham	male
AyahG	male
aya-hossam	male
AyaKhaledSaber	male
ayalkadi	unknown
Aya.MK	male
ayat	female
Ayat	female
ayatat7adaeltareek	male
ayatiti	unknown
Ayatm	male
ayback	male
aylool	male
aymammemo	male
ayman	male
Ayman	male
ًAyman	male
ayman011	male
ayman0700	male
Ayman%20Abdel-halim%20Ali	male
Ayman%20Rezk	male
ayman35	male
ayman473	male
Ayman600	male
ayman7295	male
ayman.abdelaal	male
AymanAboelsaad	male
aymanaliali	male
Ayman.Bassiony	male
aymanghandour	male
Aymanhaiba2	male
ayman.hassan	male
aymanish	male
aymanlouoiz	male
AymanMagdy67	male
Ayman_mamdouh	male
aymano_99	male
Aymanov	male
ayman.ramadan	unknown
ayman.rbm	male
aymansaad	male
Aymansamir2003	male
aymansayed1	male
Ayman.shawky	male
aymoooooooon	male
ayoooh	male
Ayooooot	male
ayos	male
ayoub	male
Ayoub	male
Ayoush88	male
ayoussef	male
ayouub	male
aysha	female
Ayyad	male
az	male
AZ	male
A.Z	unknown
Azeemos	male
A_Zima	female
aziz	male
Aziz	male
azmy	male
Azomor	female
azza	male
Azza	male
azzah	female
Azzamoez	male
Azzazy	male
Azzouni	male
b3lool	male
BA	male
Ba7r	male
BaaGa	female
babygirl	female
bacaar	male
Bacbac	unknown
badawi	male
Badawy	unknown
badieo	unknown
badr	male
Badr	male
Badrashini	female
badreldinahmed	male
Badry	male
Baha	unknown
Baha2	male
bahaa	male
Bahaa	male
Bahaa%20Megahed	male
bahaaelshafei	male
Bahaa_Ghaffar	male
baheer.ibhar_1962	female
baher	male
Baher	male
BaherAbouseif	unknown
bahgota	female
bahii	male
Bahrawy	male
bakasho	unknown
bakenzo	male
bakh	unknown
bakhbakh	unknown
Bakr	male
bakrah	female
Bakrov	unknown
Bambadax	male
bamboutsha	female
Banaja	female
bangora	female
Banna	male
Bannoor	female
Bara	male
Baraa	unknown
baraka	male
barbie	female
Bardawily	unknown
bardisi	male
basant	male
Basant%20Abdel%20Fattah	unknown
baseet	female
basel	male
Basel	male
basem	male
Basem	male
basem_aly	male
BasemAssem	male
Basem-Samy	male
basemsmile	male
bashandy	male
Bashboshi	male
basio	male
basiouny	male
basm	male
basma	female
Basma	female
Basom1980	male
bassam	male
Bassam	male
bassam.elhawary	unknown
Bassant	unknown
Bassel	male
basselzaki	unknown
bassem	male
Bassem	male
Bassem%20Georges	male
bassem3312	male
Bassem.hany	male
BassemNabil	male
BassemSami	male
bassem.taha	male
basset	male
bassoum	male
basuonie	male
batates	female
Batatsaya	female
Batigoal	male
batigol2020	unknown
Batman	male
batman2000	unknown
Batool	female
batot9080	unknown
batoul	female
battot88	unknown
BaYaD	male
bayan	female
Baygot	male
Bayoumii	male
Bazoo5	male
beanie	male
Beauty	female
bebaawahba	female
bebo	male
Bebo	male
BEBO	male
bebomallah	male
bebooo	male
Bebsy	male
Beco	male
Bedeer	male
bedingan	female
bedo	female
bee7o	female
BeeBoo	male
Beeboooo	male
Behery	male
Beissy	male
Beko	male
belal	male
Belal	male
BelalEslamIbrahem	male
Belall	male
BelalPola	female
belalt	unknown
bello	male
bemen	female
benno424	male
bent10	male
Bent_Elkady	male
benyamienfarouk	unknown
benzene	male
benzika	female
Be$o25	male
bergy	male
besbes	female
besbesa.82	female
besher	male
Besho	female
Beshoo	female
beshoy	male
Beshoy	male
beshry	male
beso	male
besoprince360	female
besso	male
Bestdolphin	male
bey2ollak123	female
Bey2ollak_Enta	unknown
bey2olly	unknown
Bey2oloo	male
bezo	male
Bezo	male
BGzr	male
bianca12345	female
bibo	female
BiBo	female
bibooo	female
bidilabidiamro	male
Big	male
BIGBaby	female
bigcaesar	unknown
Bigdaddi	male
bigdlebsh	male
BigeMahdy	male
big-Moe	male
Bigooooo	female
BigT	female
Biko09	female
bikobiko1	female
Bikoo	female
bilal	male
Billy	male
Bilota	female
Bimmer80	female
Birdy80	male
biroo	male
Bisho	male
bishoy	male
Bishoy	male
bishoyezz	female
Bishoy_louis	male
bishoy.yassa	male
biso	male
bisobiso	male
BizO30	male
bk	male
black	male
Black	male
blackhorse5	male
black_horsee	male
BlackLegend79	male
blackmore69	male
blb3	female
bloop	male
blue_espo	female
bluefire318	female
BlueGhost	female
Blue_Pisces	female
blurple	male
Bmboucha	female
bmm	male
BMW	male
BNazif	unknown
BNofal	male
bo7s	male
bob	male
Bob	male
Bob2008	male
bob63	female
bobbinatrix	male
bobka	female
bobo	male
BoBo$	male
BoBos	male
body	male
bofahd	unknown
Bogy2012	female
boke	unknown
Bokkaz	female
bol	male
bolbol	male
bolla	male
BoLLa	male
bolyosh	male
Bomboooo	male
BOMZA	male
Bonbonaya	female
bonbonetooo	male
Bond	male
BONDEEK	male
bondock	male
Bondok	male
bondok80	male
bono	male
Bonzi	male
bonzy	male
boodi	male
BoodonMido	unknown
boody	unknown
Boody	unknown
BooDy	unknown
boodyswim	male
Boodzz	male
boogyz	male
boomba	male
Booo7a	female
boooda	female
BoOoniNg	unknown
Bops70	male
borhan	male
Borhan	male
BoRiOOooOO	male
BosBor	male
bosbos117	male
bosbos90	male
Bosha	female
boshaa	female
Bo-Sha-D	male
boshoo	male
boska2	female
BOSS	male
bossy_mm	male
bosy	female
boten99	male
Botsh	male
Bouby	male
boudda	female
Boudy	female
Boudy78	male
BoudyAK	male
Bouki121	male
Boukiee	male
Boulos	male
boura	unknown
boxere5	male
braveboy6666	male
braveheart2	unknown
braveheart_mak	male
bravesoul	male
brolosy	female
BruceWayne	male
bruin	male
Bu	male
Bucho	male
Buda	male
bukbuk86	female
buklaweez	male
bullma33	female
burai	male
by2olak09	female
by2olly	unknown
C200Komp	unknown
CaireneGirl	unknown
Cairofayoum	male
calamity	female
Caliepso	male
camille	female
cannibal	unknown
CAP.	unknown
Cappiko	male
CapT.Ahmed	male
captain	male
Captain	male
captain_fawzy	unknown
carabnts	unknown
cargyriou	male
Carizma	female
Carla	female
carlalolo	unknown
carlos	male
caroline	female
carolinelabib	unknown
casa	male
Casanova	male
cascotopia	female
casta	female
Catherine	female
Cathy	female
cecchino	male
cena	female
cetrooo	female
chahine	male
Chapeau	male
chedeed	male
Cheefo010	unknown
cheetah1975	unknown
Cherif	male
cherif13	unknown
cherif357	unknown
Cherifbadr	male
cherine	female
cherries	female
chezbendo	male
chicco	male
chiccooo81	female
Chico	male
Chico_196	female
Chico77	female
Chifo	female
Chiquita	female
Chiro7997	female
chocomayar	unknown
choria	male
chouaa	female
chris	male
Chris	male
Christinaa	male
christine	female
Christine	female
CIA	female
cindrella	unknown
CK	male
CK.McBaraya	female
Clara	female
CLICK_GSM	male
Cloudy	unknown
CN	male
cobra	male
cocadoz	female
Cocojumpo	female
Cocu	male
colombo	male
concord	male
Cono	male
conq	male
conswa	male
cool_drdido	female
corn	male
Corny	male
costa	male
coucou	male
covo	female
Cox	male
Cptnoradwan	unknown
crazy	male
cruiser80	male
CSR	male
Cuddlies	female
Cun-Cun	female
cybertronix	male
cyclops	male
Cyrano	male
Cyrax	male
D	unknown
%D8%A8%D8%A7%D8%B3%D9%85%20%D8%AD%D9%84%D9%82%D8%A9	male
d911	unknown
%D9%84%D9%84%D9%87%20%D8%A7%D9%84%D8%A7%D9%85%D8%B1	unknown
%D9%85%D8%AD%D9%85%D8%AF%20%D8%A7%D9%84%D8%B9%D8%B2%D8%A8	male
DA	female
dabbish	male
dactara	female
dado	male
Dafdof	female
Dahlia	unknown
Dahmash	male
dahmousha	female
dakroury	female
Daks	female
dalia	female
Dalia	unknown
Dalia.	female
daliaamrh	female
Dalia-ghazal	unknown
daliakhairy	male
Dalidazz	male
damasry	male
damin	female
damu	male
DANCE	male
Dandana	male
dandouna	male
Dandouna	male
Dandouna100	male
Danduzzie	male
Daneal	male
Danny	male
DanyaHammad	female
Daoud	male
daraabdelaziz	male
Dareen	male
Darkangel78s	male
Darkcave	male
Dark_m_00	male
DarkMan	male
darrsh	male
darsh	male
Darsh	male
darwesh	female
david	male
David%20Selim	male
davidA	unknown
davidnady	female
Davidovich	female
Dawlatly	male
dawooda	male
dawoud2012	male
daylight	female
Dayman	male
D.B.C	male
dbdb	male
DD.	female
D.Dwidar	female
debsh	female
DeDa	female
dee	female
Dee3939	female
Dee7	female
dee_92	male
DeeB	female
deebo0oZ	female
Deebss	female
DeebZ	female
deeda223	male
deedaah	male
Deee75	female
deemos	male
deep	male
degla	male
delhelw	unknown
delrizo	female
delsheemy	unknown
Demaghy	female
demiana	female
Demos777	female
DeNdEn	female
deoky	male
deoooooo	female
Depos	male
Deragon	female
derzy	unknown
desso	male
devilia	male
DevilWolf	male
Devo	male
Dew	male
Dewan	male
deze.daboss	male
DGaballa	female
Dh	unknown
dhesham	unknown
dia	unknown
diaa	female
Diaa	female
diablo2050	female
diamantina	unknown
diana	unknown
Diana	female
dianaags	female
dias862004	female
DiDa	male
didi	female
Didi	male
didi11	male
Dido	male
Dido11	male
Dido1995	unknown
DidoBek	male
Didoo	male
didy	male
diesel1	unknown
Dieskey	female
dieso	unknown
Difalla	female
diii	female
Dimooos	male
dina	male
Dina	unknown
Dina0Elkelany	female
Dina0hassan	male
Dina%20El%20Behiry	unknown
Dina%20Foda	female
Dina%20Mohamed	unknown
dinaadelta3lab90	male
dinaagour	unknown
DinaAtalla	unknown
dinaiskander	female
dinar	unknown
dinasmail	male
dindana	male
DiNky	unknown
Dino	unknown
DinoMassry	unknown
Dinooo	female
dinos4	male
dinoz	male
diroo	male
Disaster	female
discoverer	female
disert	male
dixy	female
DizerGoo	male
DMabrouk	male
dmekawi	female
dmoustafa	female
DNAM	unknown
doaa	unknown
Doaa	female
Doaa%20Elmosalamy	male
Doaahafez	male
doaazahran	male
doan	female
doctorkhaled	male
doda	female
dodge_v	male
dodi	unknown
Dodi23	unknown
Dodisam	male
dodo	unknown
DoDo	unknown
DoDoMostafa	female
dodoshisho	female
Dodovido	female
dodx	male
Dody	female
dody1010	female
dody.abdelkhalek	female
dodydoux	female
dodz	female
dodz_07	female
dodzi28	male
doha	female
Doha	male
dohamagdy	female
dola	male
DolFiN	male
dolly82	male
doma_4	male
Don	male
DonDon	male
DonDon.Abed	male
donekamello	male
Don_omar	male
Donutz	male
Donz	male
donzino	female
Donzy	female
Doo	unknown
doo7a_92	female
doodie79	female
Doodo	female
doodzy	female
Doodzy3	female
Doola	female
doola80	female
doolz	female
Dooma85	male
Dooola	female
Doooo	female
Doosh	female
Dormania	male
Dorz	male
dotz	male
dou	unknown
doudi	male
doudz	male
DouNaguib	male
doush-504	unknown
Doushaaa	male
Douu	male
Douz	male
Dowidar	male
dr	male
dr.	male
Dr	male
Dr,	male
Dr.	female
dr_3beed	male
dr.3mr	male
dr.7ooda	male
Draemtime	male
dragoo88	male
dr_ahmed_84	male
drahmedbelal	male
drakool	male
dr.alaaelhusiny	female
DrAli	male
dralikhalil	male
Dr.Amira	male
dramrhosny	male
dranehs	male
Drayam	male
dr.bin.mansour	male
dr.botros	male
drcelio	male
drdz	male
Dr.Ehab	unknown
Dr.Emam	male
dr-etch608	male
Dr.Ezzat	unknown
drfadyfakhry	male
Dr.GM	male
Dr_haitham	null
dr.hamouda	female
Dr.Hazem	male
dr/heba	male
Dr.Hema	unknown
dr_Hoka	male
dr.ibm	male
drifting	unknown
driver	male
drkafy	male
Dr.Khouly	male
dr.m	male
Dr.MacConKey	male
dr.mhe	male
dr_mhmd	male
drmhsa3ed	male
dr.micho	female
Dr.mina_hany	male
Dr.Mohamed	male
drmohamedo	female
dr.mohammed	male
Dr.Moheb	male
dr.mostafa.azzab	male
DrNose	male
dr.osama	male
drpinkfloyd	unknown
dr_pt	unknown
Dr_salah15	male
Dr.Samar	male
dr.seif	female
Dr.SHADI	male
Dr.Sherif1976	male
Dr.shyma	male
Dr.Tamer	male
Dr.Terry	male
drwaleed	female
Dr.Y	male
Dr.Yahia	male
dryamen	male
drzelikha	male
Dr-ZIZO	male
DShamy	female
dslaymn58	male
dstructor	male
Duaa	female
dubai_mody	female
Dubiiz	male
dude123	male
dudiee	male
duke	male
Dunzy	unknown
DuSallam	unknown
dusty	male
E	unknown
Eagle1	male
EAGLE84	female
eaiad75	male
Easy	male
ebaa	male
Ebehman	male
ebnmagdi	male
ebo	male
Ebraheem	unknown
ebrahim	male
Ebrahim	female
Ebraihm	male
echoman	male
economist	female
ed73	male
edar	male
edda	unknown
eddie	unknown
Edrees	female
Eduardoo	female
eeltawansy	female
eess	unknown
Eeta	male
Egoooooooo	male
e.gouda83	male
Egy	female
Egydolphin	male
Egymariner84	unknown
Egypt	male
egypt2020	male
egyptian00001	male
ehab	male
Ehab	male
Ehab12	male
ehab_14	male
Ehab%20Manharawy	male
Ehab_Hamdy_k	male
EhabHoobaz	unknown
ehabkerdany	male
ehabsallam	male
ehadary	male
EHI	female
eid	male
Eid	female
Eid_2013	male
Eihab	male
einmug83	unknown
eino	unknown
Eissa	male
Ekabil3000	female
EKhedr	male
ekids	male
ekowo	unknown
el	unknown
El	female
El3abbady	unknown
el3araby	unknown
el3atalan	unknown
El3gouz	male
El7ag.Daboos	unknown
el7aty	unknown
el8atreef	female
elagaty	unknown
Elagroudy	male
elaiwa	unknown
EL.AMASH	unknown
elarabim	male
Elarousi	unknown
elashkar81	unknown
Elawa	unknown
Elazazy	female
El-Azmirly	female
elbamby	male
elbasha	male
El_basha	male
elbe7ery	unknown
ELBerenss	unknown
elboss3oss	female
Elcoach	unknown
eldahaby	male
eldeeb	male
El_doc	unknown
El-dod	male
eldolphin	unknown
Elfares	male
elfarida-134	unknown
elfer3on_elmasry2008	unknown
elga7ed	male
Elgarf	male
elgendy55	unknown
elgez	unknown
ElGimmy	unknown
elgizawy	unknown
elguindi2011	female
elhabra.kadabra	unknown
elhagry	unknown
elhaima	male
El-Hoot	unknown
elhusseiny	unknown
Eli	unknown
El-iTCH	unknown
el-k	unknown
Elkady	male
Elkawass	male
Elkersh	unknown
elkhabeer	unknown
elkhiat	male
Elkholy_here	female
Elkhwaga	female
elking	unknown
elkodwa	unknown
elkoptan	unknown
Ellaboudy	unknown
ellawendy_85	unknown
Elmakdoni	unknown
elmaxxx	unknown
ElMaytsamash	unknown
elmentos	male
elmigo	unknown
elmohandes1967	unknown
el-mon	male
elnemr	unknown
ElNodz	unknown
Elpopelkpeeer	unknown
Elqersh	unknown
EL_RaEi	unknown
Elsabie	male
elsahhar	male
Elsareee3	female
elsayed	male
Elsayed	unknown
elshabrawi	unknown
Elshamy	male
elsharkawy	male
Elsheikh	unknown
Elsir	unknown
Elsokary	female
Elsweefi	unknown
Eltanamly	male
elU	male
elwadmezoo	male
Elwakeel	female
ElwAn	male
elwany	male
Elwes	unknown
elza3em	unknown
elzeem	male
elzoghpy	female
Elzoz_	male
em	male
emaaaaan	male
emad	male
Emad	male
Emad.Adel	male
emadelshimy	unknown
emadhamed	unknown
emadnabilgamal	unknown
emadselim	male
emadwadie	male
EMahrous	male
emam	female
Emam	female
Emamy	male
eman	male
Eman	male
Emanadel	female
Emanhatw	female
emanW	female
Emara	male
Emem	female
emii	unknown
emil	male
EmKhashaba	male
EMMO	female
emmyrose	male
Emmzoo	female
emnegm	female
EMO	female
emoooo141	female
emy	female
Emy	female
emy_afk	male
emysmsm	unknown
Emz55	male
en	unknown
E.N	female
enabeel	female
enaguib	male
enas	unknown
Enas	male
eng	unknown
eng.	male
Eng	male
Eng.	male
Eng%20Ahmed%20Amin	male
Eng-Ahmad	male
eng_ahmad_farouk4	unknown
eng.ahmedabdelhalem	male
eng.AhmedShokry	male
Eng.amirbakr	male
eng_ehabgamal	male
Eng.eman	male
eng.essam.hussein	female
eng.esslam	male
enggalileo	male
enghesham22	male
Engineer	male
eng.karim	female
Eng.Karim	male
Eng.khaled	male
Englilo	unknown
eng.Maged	male
Eng.Mahmoud16	male
engmahmoudfattah	male
eng.mahmoudhisham	male
eng.minageorge	unknown
engmkamal	male
Engmmohie	male
Eng.mode	female
Eng.Mohamed	male
engmohamed_ahmed_kamel	male
engmohmah	female
eng_mostaf	male
eng_msamy	unknown
engola2003	female
Eng.Sami	female
Eng.SHady	male
eng.shekooo	male
Eng_sherboo	unknown
engwaelgalal	unknown
eng.walid	male
engy	male
Engy	unknown
Engy%20Ali%20Saeed	female
Eng.yasser	male
EngyFaltas	male
Enigma	male
enirbobo	unknown
EnjyMaher	unknown
ennumair	male
Entesaar	male
Eri	unknown
erianaziz	female
Es7ak	male
esaam.tawfik	unknown
Esaf	male
Esam	female
ESawaf	male
esh0o0	male
esht	male
eslam	unknown
Eslam	unknown
EsLaM	unknown
Eslam%20A.elfattah	male
Eslam%20Anwar%20Gamil	male
Eslam%20El%20Shazly	male
Eslam%20Salah	male
eslam9	unknown
EslamAshraf	male
eslameldaly	female
ESlamElHawary	male
Eslam_elmansy	female
eslamelsaeedsa	male
eslamelshater	male
Eslameslo	male
eslam.fetouh	male
eslam_h	unknown
ESLAMOV!C	male
Eslam_S	female
Esma3eel	female
Esmail%20Mohamed	male
esmii	male
Esraa	male
Esraa%20R.%20Helal	unknown
EsraaAhmed	male
esraae	male
esraafarag	male
Esraa.Moe	male
essam	male
Essam	male
essam711	male
essamali	unknown
essambakeer	male
essames	male
essamsha3ban	male
essamsherif7	male
essamyussef	male
esso	female
Esso_1	male
esso18	female
ethar	male
Etsh	unknown
evita	male
evOlutiOn70th	male
ewady	male
Ex	male
excavator	male
Eyad	male
eyadwael	male
eyecairo	male
EyeCare	male
ezz	female
Ezz	male
ezzat	male
ezzatadelsolima	unknown
ezzeily	female
ezzeldin	female
F	male
Fa%20K%20Eh%20PH	male
fa2oosa	female
fa3el	unknown
Fa3el	male
Fa3elet	female
fa3eletkheir	female
fa3el_khair	male
fa3el.kheir13	unknown
fa3elkheirmatakhedsh	male
fa3l	female
faaawzi	male
FAB	male
fabajo	male
Fade	male
Fadel	male
fadi	male
Fadi	female
Fadi%20Samir	unknown
Fadl	male
Fadwa	male
fadwasakr	female
fady	female
Fady	male
Fady3	male
fady89	female
fady.adel	male
Fadyanis	female
fadybhy	male
fadygamal	female
fadygindy	male
Fadyguirguis	female
FadySherif90	male
fadysoliman	male
fadywg	male
Fahd	female
fahim	female
fahmy	female
Fahmy2000	male
Fahmyzz	female
Faiad%20E	male
Fakharolli	male
Fakhorya	female
Fakhr	unknown
FALCON	female
fanan82	male
fantastic1	female
faonas.	female
far3'ly	female
Far7a	female
farah	female
Farah	female
farah13	female
Farahma	female
faramawy2008	male
Farghaly13	female
farhouda	female
Farid	male
farida	unknown
Farida	female
Farida.Sherif	male
farifary	male
farooos	female
farouk	female
Farouk	female
Farrah	female
farrahmogh	female
fashnawy	female
fatema	female
fatima	female
fatla82	male
fatma	unknown
Fatma	male
Fatma%20Samir	unknown
fatomz	male
fawzy	female
fawzybeh	male
fayez	male
fayrouz	female
fayrouzty	female
Faysool	male
FaZouRa	male
fboushra	female
feeeedz	female
Feiky1	male
fekoleko	female
Felfel	female
felo	male
FeMoAwi	female
ferferra	female
Fert	female
fevo	female
fezba	female
fido	male
fidonoor	male
fifi	male
Figo	male
FiREBiRD	male
FireStorm	unknown
fjdjdjdjdj	male
Flamingo	male
fmaghraby	female
f.mumdouh	male
fnasrr	unknown
Fnnan	male
foash	female
fodoly66	male
fofo12345	unknown
foka	unknown
fokkak1235	female
Follatos	male
FollowTheStar	male
Fonna	male
Fonny	female
food_lover	male
Fortune	male
fotna	male
Fou	male
fouad	male
Fouad	male
fouadelsabban	female
fox	male
Fox	male
foxkeen	male
foxter	male
Franco1	unknown
franko	female
Freddy	male
free	male
free_angle	male
Freespirit	unknown
freska	male
friday_911	female
fridaygoda	male
frouzi	female
Frozen	male
ftharwat	unknown
fudz	unknown
funky	unknown
FuseMe	unknown
G	male
Ga3far	male
Gaafar	male
gaafary	male
gabbas10	male
gaber	male
Gabson	male
Gad	male
gadelio44	male
gadosky1980	male
Galal	male
Galal%20Aly	unknown
galalus	male
galeleo	male
galhoum	male
gamal	male
Gamal	unknown
Gamecock12	male
Gamed	male
Gamela	unknown
gamilo	male
gammal888	male
Gamolly	male
gamy	male
Gar7ii	male
Garawany	female
Garhy	male
gashama	male
Gasser	male
Gasser%20Akila	male
Gazzar	male
gbedeawy	female
gdariat	female
gebreel89	male
gecanora	female
Geda	male
geddo84	male
Geedos	female
geeez	female
gego	unknown
gehad	male
Gehad	female
gehadfarouk	female
Gehadsaber	male
gehan	male
gelan	female
gelgel	male
gello10	male
gemeiza	male
gemi_a1	male
GemiAcetal	male
gemo	male
gemy684	male
gemy.zoom	male
gendawy	male
GenierO	male
Gentle	male
Gentleman	male
geo123	male
george	male
George	male
george255	male
georgeatef87	male
georgemalakh	female
georgesamir	unknown
georgescherif	male
Gera	male
Gerges%20Dawood%20Nazem	unknown
gero	unknown
Gersy2000	female
G.G	female
gggggggggggg	male
ghada	female
Ghada	unknown
Ghada%20Taher	female
ghada3d	male
GhadaHanem	female
GhadaZed	female
ghadeerAF	unknown
Ghalab	male
ghaly.112	male
ghanan	unknown
ghanz	male
Gharably	male
gharbawy	male
gharibz	male
Ghawas	female
ghazaly	female
ghazzalaa	male
ghobashi	male
Ghonemia	female
ghost	male
Ghost	male
GHS23	female
ghweil	female
Gido	female
Gigi	female
GIGI	female
Gigito_Thawrageya	male
GiGitta	female
GIHA	unknown
Gilan	male
Gina	female
gina.ghabrous	female
Gino	male
gisha	male
gis_mosap	unknown
givaraelgafy	unknown
Gladiator	male
gladiator13	male
glamorous	female
g.mohamed	female
go	female
go7a	male
Gobran	male
Goda	female
godway	male
Gody	female
godzela_2006200043	female
GoG	female
gogo	male
Gogo	female
gogo2812	male
gogoz	male
Gohary82	unknown
goker	unknown
gola	unknown
golden	unknown
Golden	female
GoldenRose	female
Gomasrye	unknown
goobi	male
goofy1989	female
goudaelkibeer	male
goudas	female
gouka	male
GPS	female
graphene	male
great.mero78	male
Greny	unknown
gsjsh	unknown
GSN	unknown
gwady	female
h	male
H	male
h0bz	unknown
h2806	male
HaaaP	male
habata	male
habbob81	female
h.abdal	male
habdelhameed31	male
Habeeba	female
habhoob	male
habib	male
Habiba	female
haboushi	female
Habozekry	female
hadeel	male
Hadeel	male
hadeer	unknown
hadey	male
hadiamahmoud	male
hadii	male
hadil.fayad	unknown
Hadir	male
Hadirhassan	male
hadir.salhin	male
hady	male
Hady	female
hady.ahmed	female
Hafzy	male
hagagi	male
Hagar	female
Hagerology	male
haggag	male
haidy	male
haidy.wali	male
Haikal	male
HaikooL	male
Haissam	male
haissum	male
haitham	male
Haitham	unknown
HAITHAM	male
Haitham95	male
Haithamcherif	unknown
haithamfarag	male
Haithamserag	female
haithamsorour	female
Haithem	male
Haitian.emira	male
hajeroni	male
hakalamaka	male
hakeem	female
Hakim	female
HAKIM	male
Hala	male
Halafw2a	female
hala_hamdy	female
Halasab	female
HAlEmam	female
halemmmz	male
halla	male
hallaelhosainy	unknown
hamada	male
Hamada	unknown
hamada007	unknown
Hamada%20Ahmed	unknown
Hamada75	unknown
Hamada890	unknown
Hamadaawad	unknown
Hamada.Farouk_2003	male
hamada_hegazy	male
Hamadasom3a	male
hamahuny	male
Hamaky	male
hamdy	male
Hamdy	male
hamdy44	male
hamed	male
hamed.mostafa	male
Hameedo	male
hamfry	male
hammad	male
Hammam	male
Hammouda	female
hamodi	male
hamooode	male
Hamosha	male
hamouda	male
hamsa.mansour	male
hamza	male
Hamza	male
Hamza01	male
hamzawy7794	female
hamzoza	female
Han90	female
hana	unknown
Hana	male
Hanaa	unknown
Hanaahmed651	unknown
Hanamaya2	male
hanan	female
Hanan	unknown
hanan.samy.ahmed	male
hanasalma	female
Hanassar	male
handoush	male
Hanem	male
hani	male
Hani	unknown
hania_10	female
hani_aast	male
hanielbanna	male
haniismail123	unknown
HaniSaadawy	unknown
hanizikri	unknown
hannahalt	male
Hannaux	female
hannout121	male
Hanoo	male
hanoon	unknown
Hanoud	male
hanoush	male
Hanush	unknown
hany	unknown
Hany	male
Hany%20Mhanny	female
Hany%20Yacoub	male
hany2608	male
hanya	male
hanyarram	male
HanyDavinci	male
Hany.Eladley	male
hanyHany	male
hany.kamal	male
Hany.Magdy	male
hanyosama85	male
hanyramsis	male
hanyrezk	male
hanyshehatah	male
hanzyy	male
hashem	female
hashem30789	male
hashem_h	male
hashen	male
Hashim	male
hassan	male
Hassan	male
Hassan06	male
Hassan%20Beltagy	male
Hassan%20M.%20Hazem	male
hassan250	male
HassanAdel	male
hassanalgabry	male
Hassanator	male
hassaneldeeb	male
Hassan.Elkordy	male
hassansharkawy	male
hassy	male
hatem	male
Hatem	male
hatem.fast	male
hatem.g.Amer	male
Hatemmokhtar010	male
hatemnaga	male
hatem.sayed	male
hatem.temtem	male
Hatooom	female
Hatrek	male
Hawk	male
Hayehia	male
Hayssam	unknown
haytham	unknown
Haytham	unknown
Haytham123456	unknown
haytham299	unknown
haytham76	unknown
haytham_eg	unknown
haythamfci	male
haythamtrmg	male
haythamwagih	male
haythem328	male
hazem	male
Hazem	male
hazem1973	male
Hazem2007	male
Hazem23	male
hazem90	male
Hazemdido	male
hazemgogary	male
HazemHagag	male
hazemhazemhazem	male
hazemhossam	male
hazemmedhat	male
hazem_morad2002	female
HazemRomaih	male
hbadr	male
hdm76	female
He	female
he75768	female
heart	unknown
heba	female
Heba	female
Heba%20Ashraf%20Elkholify	male
Heba_27	unknown
Hebaa	unknown
hebaasamir	male
HebaAZM	male
HebaFF24	unknown
heba_hesham	male
hebakamal	unknown
Hebamonsif	male
hebamourad	female
HebaNasr	male
hebas	male
HeBoso	unknown
heddy	female
hedeiwy	unknown
Hefnawy	unknown
hefnawy72	male
Hegazy	male
hegui	unknown
Hegz26	female
Hegzo8	female
Heidarz	male
heidi	female
Heidi	male
heidicar	male
heidy	female
helal	unknown
Helal	unknown
helbawi88	female
helbo	male
heldeghaidy	female
heldessouky	male
h.elgez	male
hell-t	male
helmy	female
Helmy%20Abu%20Elftouh	male
helsaeed	female
Hema	male
hema1234	female
hema558	female
hemadigital	female
hemahdy	female
hemdo	female
hend	female
Hend	male
henda	male
Hendoze	male
Henkeshman	male
heno79	male
Henry	male
hermes2070	male
hero	male
heroicguy	male
hesham	male
Hesham	male
hesham1953	male
Hesham%20Banhawy	male
Hesham62	male
heshamaboelnasr	male
HeshaMagdi	male
heshameletreby	male
hesham.f	male
heshamgazzar	male
heshamredsea	male
heshamsharaf	male
heshamtaher	female
hesham.yehia	female
heshamzone	female
heyawi	unknown
HeysaH	female
HF	male
H.F	male
hg200148	female
HGENDY	female
hgroup.2004	male
HH	male
hhalafawy	male
HHalwagys	male
hhamdy	female
H.Hegazi	female
hhhhhhhhhhhhhhhhhhhhMilkyway	male
hhhhhshshsahhahaha	male
Hibizzz	female
Hicham	female
hiiishooo	female
hima	female
Hima	female
hima27	unknown
himaaa	male
himahegazy	female
Himaoss	unknown
HIMAZONE	male
hind	male
Hindawy	female
hisham	male
Hisham	male
Hisham%20Issa	male
Hisham%20Mohsen%20Bahgat	male
hishambb	male
hisham_hassan	male
hishammedra	male
hishamnagy	male
hishamzidan	male
hishio	male
hisho1234	male
Hishokandil	male
hishoo	male
hishoo2223	male
hitch	female
hithem	male
hitman477	male
hkahky	male
hkamesh	male
hkd	male
hkn	male
HMamdouh	female
hmbelal	unknown
hmeid	female
hmk	male
Hmonir	male
h_moshneb	male
h_mytkhebtsh	male
HN	female
hnabil	female
Ho55am	female
hoba	male
Hobbba	male
hobbyist	female
hobz	unknown
Hobz	unknown
hoda	female
hoda1204	male
hoda19-84	male
HodHodinho	male
hohoos31	female
homoss	unknown
honda	male
honna	male
honstly	female
Honzz	male
HoobaDarsh	female
Hoobza	female
Hooda51	female
hooobaa	female
HooYa	male
hopeless	female
hoppaz	male
Horiz	male
hornet	male
hos	male
Hos	male
Hosam	male
hosama	male
Hosam_Hosny	male
hosny	male
Hosny	male
hosoo	male
hoss	male
hossa	male
Hossa	male
hossam	male
Hossam	male
Hossam0115	male
Hossam02	male
Hossam%20Eldien%20Adel	male
Hossam%20Eldin%20Mohamed	male
Hossam%20Mohamed%20Ibrahim	male
Hossam7903	male
hossam956	unknown
hossam.ahmed	male
hossam.atty	male
hossamawahab	male
hossamcu	male
hossamfarran	male
hossamfoudah	male
Hossamo	male
hossamy	male
hossawy	male
Hossein	male
Hossny	male
Housam	female
housammansour	unknown
houssam	unknown
Howwa	female
hrakaiby	female
hRakhawy	male
hrashdan	female
hrashmawi	unknown
hs	male
H.Sabra	unknown
hsaidum	female
h.saied	female
HSemary	male
hsemedah	female
H.shaheen	female
hshehsushgsjsns	male
Hsinbawy	male
Hsn%20Eldeeb	female
hss	female
HT	female
htalawy1	female
htc	male
hteta	female
Huda	male
Hudzzzzz	male
hunnymiho	male
huseein	male
Huss	male
hussain	male
Hussam	male
hussayn	male
hussein	male
Hussein	male
Hussein%20Mohaned	male
HusseinAhmedAli	male
Husseinchaaa	male
Husseinenan	male
husseinselim	male
hussein_soliman	male
hussien	male
Hussien	male
hussien1003	male
hussieniViC	male
Huzefa	male
Hydrzone	male
hyper	female
hysm	unknown
Hysm	unknown
hzahran1	male
hzanaty	male
I.	male
iAhmedAdel	male
iahmedeid	male
ialfy	male
iali	male
ibn	unknown
Ibn%20Elnil	male
ibnGamal	male
ibntawfik	male
iboo	male
ibraheem	male
Ibraheim86	male
ibrahem	male
ibrahemabass	male
Ibrahem_elkhabery	male
ibrahim	male
Ibrahim	male
Ibrahim.	male
IBRAHIM	male
ibrahim92	male
ibrahim.alham	male
ibrahim_ali337	male
ibrahimm	male
ibrahimsafwat	male
ibrahimsamaan80	male
Ibrahim_sayed	male
ibrahimwaelab	female
IbraLotfy	male
Icarus	female
icon	male
idriss	female
iei82	male
ifahmy	male
Ifaridtemp	male
ihab	male
Ihab	male
Ihab%20Daghash	female
Ihab%20William	female
ihabattia	male
ihabchina	unknown
ihab.dorra	unknown
ihabsaad	female
ihosny	male
ijlal	unknown
iKeira	female
ikhater	female
ilegy	female
I.Madkour	male
iman	unknown
Iman	female
I_Man	unknown
iman82	unknown
Imane	male
imanelbayadi	female
imanemo	male
ImissHer	unknown
imo	male
I.M.T.S	male
inaramez	female
Inas	male
IncredibleMoe	female
ingie27	female
ingik	unknown
Ingy	male
ingy12345	female
IngyAbouElEnin	unknown
inish	unknown
inter00	female
invest_eg	female
ireedz	male
Irene	male
I.Salama	male
isaryeldin	male
isb	male
Iskandar	male
islaaam	male
islam	male
Islam	male
islamboshy	male
islam.fetouh	unknown
Islam'Galal	male
islamhelal	male
islamkhamis	male
islammohamedthabet	male
islamramzy	male
islamwaheed	male
Islam.youssef	male
isma3il	unknown
ismail	unknown
Ismail	unknown
Ismail%20EL%20Mofty	male
ismailelarabyy	male
ismail.gabbani	female
iso	male
isobhy	unknown
Israa	male
israaapple	female
italy2580	female
itato	female
itchoo	male
Itolba77	male
iWageeh	male
iyad	male
izohdy	male
jack	male
jackknifediesel	male
jackson	male
jacky	male
jacoub_daniel	female
Jailan	male
Jailan%20Nabil	male
jala	male
jaled	male
JAM	male
James90	female
JamesDin	unknown
jamesx77	female
Jana	male
Janatamer04	female
Janie	female
Jarelkamr	male
jasmen	unknown
jasmine	male
jassy81	male
Jawajiwo	unknown
Jazz26	unknown
jean	female
jejo	male
JFadly	male
Jihan	male
jihanmagdy	male
jilan	male
Jim	male
jimmsy	male
jimmy	male
-=jimmy=-	male
Jimmy	female
jimmy_aly	female
JLMFE	female
jnj	male
jo	male
JO	male
Jock	male
joe	male
Joe	female
JOE	male
Joecena11	male
Joegogo	male
JoeKaldas	unknown
JoeMaher	male
JoeyRation	male
JoeZaSnake	male
jogs	male
john	male
John	male
John%20Maher	male
johnior	male
johnkamel	male
johnn	male
Johnny	male
johnseleem	female
Joja7000	female
Jojy	male
joka	male
joke	female
jokeer225	male
joker	male
jonz2012	male
Joseph	male
josephmounir	male
josephraoof85	male
Jou	unknown
Jouka	male
Jouneer	female
JowJow	male
jox	female
JoY	male
JoyFuL5	female
jraa7oo	male
Judge	male
juicy	unknown
JulieAdams	male
junior	male
juniors	male
juru	unknown
just	unknown
Just	male
k	male
K	female
k3bool	unknown
kabdelmaguid	unknown
Kabo-82	male
Kaboky91	female
KaBoOoO	male
kady.	female
Kaherawi	female
kahk2008	male
kalbala	female
kalbaz	female
kalika	male
kalsheta	male
Kama	male
kamal	unknown
Kamal	male
kamal2011	male
kamba	male
Kamel	male
kamelios	female
kamelmoursy	male
kamelz	male
kami	male
kamolio	male
kamollo69	male
Kanboo	female
KandilEmam	female
Kandyman	female
KaNy	unknown
kao2010	unknown
kapasha	male
kapooooo	male
kapow	unknown
K-A_R	male
Karafsone	male
karamz	male
kareamkhadr	male
kareem	male
Kareem	male
KAREEM	female
Kareem%20Zhran	male
Kareem777	male
kareema	unknown
kareem_elsherif	male
kareemkarefaat	male
kareem.moh.nasr	male
kareemsabbah88	female
kareemsafwat	female
kareemtarek78	female
karem	male
karemkimo	male
Karen	male
Kariem_Hussien	male
Kariim	male
karikoz	male
karim	male
Karim	male
karim0811	male
karim1000	male
Karim%20Elhogiraty	male
Karim%20Mostafa	female
Karim%20Rahif%20Al-Masarani	male
Karim%20Taher	male
Karim3atef	male
karim.abbas79	male
karimalaaeddine	male
Kariman	male
Karim.Elgendy	male
karimessam	female
Karimezzat7	male
karimfawzy2511	male
karimgiza	male
KarimHassouna	male
KarimKaram	male
karimkomaty	male
karimooo	male
KarimOsteopath	male
karimoz14	male
karimsami	male
karimsamy	male
karim_sb	male
Karimsolyman	male
Karim.t.salama	male
karimuv	unknown
Karimzaafan	male
karimكريم	female
karkoura	male
karo0o	female
karoline	male
kaskary	unknown
kassab	unknown
kassabi	unknown
Kasseb	male
katakata	male
katalyst75	unknown
Katapoff	unknown
katbiehugffhegytyjgyitjuyvgyfgkhvvfhfhjgjjjhkhhuguggygg8bjt	female
katkoot	female
katsho	unknown
katy	male
kborno	male
K%C3%	male
kdayoub	male
keeeeeem	male
keenography	male
keko	male
KEM	unknown
kembesh	male
kemo	male
Kemo	male
kemoeltawil	unknown
kenz	male
KENZ2014	male
Kenzo	male
kenzy	male
KER	male
kero	female
Keroles	unknown
Kerolos	male
keron	male
Kerro123	male
kersho	female
kesh0o0	unknown
Kesho	female
keweiss	male
kfathy	male
kguinady	female
kh	male
kh.	male
kha	male
Khadega	unknown
KhadigaTarek	male
khairy	male
khald	male
khaldoon1984	male
khaled	male
kHaled	male
Khaled	male
Khaled1981	male
Khaled%20Mohamed%20El-Mahallawy	male
khaled587	unknown
khaled_901	male
khaled_99	male
khaledabdelg	male
Khaledahmed	male
Khaled_aziz	male
khaledazizeg	male
KhaledAzzam	male
khaled_bebo	male
khaled.eg.2009	male
khaledelrefaee	male
KhaledEzz	male
khaledhalawa	male
khaledhelmy	male
khaledkhaleel	male
KhaledMaala	male
khaledmaged	male
khaledmsalah	male
khaled.osama	male
khaledovesky	male
khaledragab	male
KHALEDSPADA	male
khaledtakeaway	male
khaled_u33	male
Khaledzzz	male
khalid	male
Khalid	male
Khalid%20Brooklyn	female
khalid.alashkar	female
khalidfathy	male
khalifa	male
kharma	male
kharoof911	female
kharshouf	male
k.hashish	male
Khater	male
Khater000	male
khattab	male
k_hazem	unknown
khella84	female
khlood	female
Khlood	male
khod	male
khodaryyyyyy	female
khokha2	female
Kholioo	female
KholiuooZ	male
kholoud	male
Kholoud	female
kholoudelwan	female
kholoudgouda	female
khomacey	male
khoooookha	male
khouja	male
kh.shousha	male
Khulud_dodi	male
kibrahim	male
KieM	female
kii85	male
Kik	unknown
kiko	male
Kiko00o	female
Kiko_2010	male
Kikobanna	female
kikzz	female
Kilani	male
killz	male
Kim	male
kimba	male
kimbiz	male
kimbo	male
KimKam	female
kimo	female
Kimo	female
KIMO	female
kimo72	male
kimo72006	female
kimo81	female
kimo9	female
kimody	female
kimojoe77	female
kimokona	male
kimomm	male
kimoo2007	male
kimoooz	female
Kimotei	female
kimovic	male
Kimovip	male
Kimoz10	female
KimZzzz	female
king	male
King	male
kingawii	unknown
kinghema	male
king.k	male
kingkhalid	female
KingTata	male
kirolos	female
Kirols	female
Kiroooo	male
kisho	female
kita2	unknown
Kitaaaaaaaaa	male
kizer	unknown
kizursuza	male
k.k.	female
klipschy	female
K.M	male
KMF	male
knzoo	male
K_O	female
kobragy	male
kobri	male
Koffa	male
Kohinoor	female
kojo	female
kojy86	female
koka	male
koki	male
koki100100	male
kokilolo	male
koKko	male
koko	male
Koko.10	male
koko15579	female
koko79	male
kokoko	unknown
kokot	male
kokowawa123	male
koky	female
kokyloly	unknown
KokZ	male
komanda	female
konami	male
konouz	female
kooko	male
korma	male
korombo	male
Kotinita	male
Koufy	male
Kouka1	female
kouky1967	male
KoX	unknown
Kozman	female
Ksakka	male
ksewedy	male
ksharaby	male
kshawky	unknown
ksherif44	male
Ksirry	male
ktallakt	male
ktawfik	unknown
Ktkhaled	male
kuny	male
kwadid	unknown
kwaity	unknown
kyacoutt	female
kyoussef	female
L	male
l9l3war	female
la	female
laalaaa	male
labib	male
laila	male
Laila	male
lak	female
lala	female
Lale	female
Lallis	female
lalou	female
lamia	unknown
Lamia	male
lamiaa.Thr	female
lamis	male
Lamloum	female
Lamy	female
lamya	unknown
lancelot	male
lara	female
Lara	male
larka	unknown
larkor1977	male
lasheen	male
lashin	male
lashinkov	male
last	male
laugher	unknown
lavito	male
Law	female
layaly	male
layla123	unknown
LayLaalaa	male
LaYosRa	unknown
Laza	female
L%C7%BF%C4%85%C3%BF%20Abd%E1%BB%87lf%C4%85tt%C4%85h	female
le	male
Leda_79	male
Ledo	female
leiamra	female
Leila	male
Leithy	male
lelo	female
lemo1983	female
lena	female
leo	female
Leopardo	female
leqaa	female
lestat1978	female
LG89	male
ligho	unknown
LIKAz	female
lily	female
Lilylooly	unknown
limo	female
Limo06	male
lina	female
Lina	male
lina1306	male
Linda	male
lipoold	female
Lithe7	male
littleworm100	female
Lizlemony	male
L.K.K	male
ll_Mohamed.Hassan_ll07	male
lnegmeldin	male
lo2lo2	male
loai.mansour	male
loal	female
loay	female
Loay	male
loayhesham	male
Loaylolo	female
lobna	female
Lobna	female
lobnamostafa	female
lol	male
Lola	male
lolizozi	male
lolla	male
loll.el.loll	female
lolloss	male
lollzz	male
lolo	male
Lolo	female
LOLO1972	male
lolo20	male
lolomedo29810	male
lolomorsy	male
loly	male
LoLz	male
loma25	male
Looby	female
lookatme	male
Looly	male
loolycoff	male
loooody	male
Loooooo	male
LordNerub	female
Lord_Vampire	male
lostsamurai	male
lottoooo	unknown
Lou104	male
Lou73	female
louay	female
louka	male
loulibesella	male
LouLiLaAa	unknown
Loulou	male
LouLou	female
Louloualy	female
louloulou	unknown
louly	female
louma13	male
louza	male
lovelyweddy	female
loveyoujesus	male
loza2013	unknown
loza45	female
loza500	male
LS2	male
L'san	male
Lshaaban	male
LShaheen	male
LTM	female
LubnaSaad	male
Lucielouca	unknown
luka	unknown
Luu	unknown
luvluv	unknown
lzoooooz	unknown
m	unknown
m.	male
M	male
M.	male
M%20L%E1%BB%99t%C5%BF%C6%B4%20Elkady	male
m25	male
m3adawy	male
m3adel	female
M3ranger	unknown
M..7amed	male
m7ammad5aled	female
m7md	female
M7md	male
m7md.lo2a	unknown
M7mod	male
M7mud	male
ma	male
Ma	male
ma2lad	unknown
ma3leemz	male
Ma7amad	female
ma7amed	male
Ma7meesh	male
ma7moud90	male
ma9ed9	unknown
maabdallah	unknown
maadist	female
maaelhakim	unknown
MAAEM	unknown
Maamoun7	unknown
maasraawy	male
maaty	male
mabahaa	male
mabaker99	male
mabdelfattah	male
mabdelhay	male
m.abdelmageed	unknown
M.abdelMalek	female
m.abdelmoniem	female
M.AbdelNaeem	male
mabdelraheem	female
m.abdelraouf	male
mabdo	unknown
M.Aboelnour	female
Mabohendia	unknown
M.Aboualhassan	unknown
MAbouBasha	male
mabrooo	male
mabushady	unknown
maclodaa	unknown
Mada79	male
mada_8691	unknown
Madany	male
Madawia	female
Madeeh.hamada	female
Madeleine%20Mourad%20Rouchdy	male
madkourt	female
mado	female
mado2210	unknown
madonna	female
Madonna	male
madoooz	unknown
Madotifa	female
Madridista	female
madridy	female
Mady	female
maelmissiry	male
mafawzy	unknown
Mafiaaa	male
maga3a	male
magamigooooooo	male
Magd	male
Magda%20Kamel	male
magda.elgebeily	male
Magdi	male
magdy	female
Magdy	male
Magdy%20Ameen	male
Magdy%20Malak	male
magdy21085	male
magdyabulela	male
magdynour	male
maged	male
Maged	female
Maged%20Rofaiel	female
maged_91111	male
magedeid	male
maged.m.habashta	unknown
magedmohamed	female
Magelan	male
magetta	female
maghoul	male
mag-houl	male
maghraby	female
maghul	female
magiez	female
magnetooo	female
magoud	female
Magsam	male
magy	unknown
Magy	male
Mah	male
maha	male
Maha	male
mahaazim_	male
Mahaba	female
mahahossam	male
mahamed.ezzat	male
mahammad	male
mah.asaad	male
mahazz	male
mahdei	male
Maheed	unknown
Maher	male
MaHeRoV	male
MaherPeto	male
maherw	male
MaherzII	male
MahEzzat	male
Mahitab	male
mahitab_m	male
Mahmod	male
mahmod.rashad.3311	male
mahmood	male
mahmoud	male
mahmoud.	male
Mahmoud	male
mahmoud1993	male
Mahmoud%20Abd%20Latif	male
Mahmoud%20Abdallah	male
MahmoUd%20Attala	male
Mahmoud%20Tharwat	male
mahmoud333	male
Mahmoud.AbdelAziz	male
mahmoud_abdelwahd400	male
mahmoudabouelgheit	male
Mahmoudadel8	male
mahmoud.atiya81	male
mahmoudbaraka	male
MahmoudDeabs	male
Mahmoud.Elhamy	male
Mahmoud.elsawy22	male
Mahmoud_Elsayed2015	male
Mahmoud_hamdy	male
Mahmoud_hatem	male
mahmoudibrahim74	unknown
Mahmoud.karar86	male
Mahmoudmahboub86	male
mahmoudmostafa	male
MahmoudSaeed	male
mahmoudsamaha	female
mahmoudsfares	female
mahmoudsheriff	female
MahmoudSolimannnnnn	female
mahoor	female
mahroush1	unknown
Mahy22	male
mai	male
Mai	male
maie	unknown
Maie	male
Mai_El-Adawy	female
maieltayeb	unknown
mai.moustafa	female
Mai.Nasser	female
MaiOi	female
maionez	male
maiouii	female
Maioush	unknown
maisara	male
Maisara	unknown
Maisoon	male
maiuku	male
Maiuoya	male
mai.y.o25	male
majeed	unknown
majoju75	unknown
mak	unknown
MAK	female
makhloid	female
makin	unknown
makmak	female
makmak'	male
malaa114	male
malak	male
Malak	male
malakb	unknown
malak.haress	male
malakyalex	male
m_alaraby86	female
maldiinii	male
Maleksassy	female
malfy86	unknown
malibrahim74	unknown
mAliH	unknown
Malky	unknown
m.allam	unknown
Mallk	male
mallooo	male
M.aly87	male
M.Alzahaby	unknown
mam3bs	unknown
mamado83	male
mamdouh	female
Mamdouh	female
Mamdouh.Salem	female
M.Amerr	female
MamoonMamoon	unknown
MAN2	unknown
Mana3	unknown
manal	male
manar	female
Manar	unknown
ManarMM	female
manarrasheed1977	female
manarsaady	female
Mandar	female
mandology	unknown
Mandour84	male
mandoursalwa59	female
Mandoza	male
manga6630	male
mangawy	male
Manhawy	female
mannas	male
mannno25777	male
mano	male
Mano	female
manona	male
manooo	male
Manor	male
mans	male
Manshy	male
manso	male
mansory	female
mansour	female
Mansour	female
mansour221	male
manssss	male
mantar	male
mar2012	male
marameroooo	male
maramz	female
marc	female
Marc	female
marco	female
marcozaki	unknown
marc_sami25	unknown
Marehan	male
marfam	unknown
mariam	unknown
Mariam	unknown
mariambehman	female
mariamekram	female
MariamEssam	unknown
mariamonsy	female
MariamTahaTaha	male
marianauss	unknown
Marianne	male
marie85	male
MarikaGee	female
marina	unknown
marina-nashaat	female
marino77	male
mario	female
Mario	female
mariocca	male
Marioom	male
Marium	male
Mark	female
mark_007	female
Mark%20Naguib	unknown
mark_Youssef	female
marmar	female
Marmar	female
marmora	male
Marmora	female
Marmoura	female
maro	female
Maro	female
maro1978	female
marojou	male
maro.mavie	female
maro.mido	female
maron18	unknown
maronisma	male
Marquini	male
marsguy	unknown
marwa	male
Marwa	unknown
marwaesmail	unknown
marwan	unknown
Marwan	unknown
Marwan61290	unknown
_MarwanAmr	female
marwanatef1	female
marwanbay	female
marwanelhennawy	unknown
Marwaneos	male
marwankabbani	female
marwapanky	female
Marwat	female
marwaty	female
marwa_yousef	male
Marwa_zaher	female
mary	male
Mary	unknown
maryam	male
Maryam	female
maryamhisham	male
MaryamKotb	male
mas3oude	female
MAS81	male
Masa	unknown
Masameso	unknown
M.A.sattar	male
M.A.Shawky	unknown
Mashour	male
MASman	unknown
masmar	unknown
masoorism	unknown
masoud	unknown
MASR	male
masriasli	male
masry	male
Masry	unknown
masryy	unknown
massed	male
massoudk	female
Master	unknown
M.Atef	female
matefezz	female
Mattar	unknown
mattarex	male
matthanaaa	male
matthews13	female
MAW	female
mawma72	female
Mawww	female
max	female
maxidizer	female
May	female
maya	female
mayada	male
Mayanne	male
mayar	male
MaYa.sweet	female
maye	female
mayeltabaa	female
may.hakim	female
MayK	male
maymayarahmad	female
maymoemen	male
maymostafa10	female
mayoshkety	female
Mayouyaaa	male
Mayoweiss	male
mayoya2711	female
maysamy	male
maysoon	male
Maysoon	male
Mayy	unknown
maz	male
Mazadona	unknown
mazaganji	male
mazen	unknown
Mazen	unknown
mazen1981	male
MazenAhmed	female
Mazenmiddle	female
mazenmostafa	female
mazfuzz	female
mazgangy	male
mazikati	male
maziota	male
Maznoo2	male
mazoo	female
mazroua	female
m.azzazy	unknown
mB	male
m_badr	male
mbakir	male
Mbalba3	male
M.balbaa	male
mbanhawi	male
Mbishr	female
m.borg	unknown
M%C3%B8%20M%C3%B8	male
mdemerdash86	male
mdp	unknown
MDZ	unknown
me	male
me7tas	female
Me7tass	male
meanmachine	male
Meb88	male
mecameco	male
Mecky	female
meda	male
medhat	male
Medhat	male
Medhat%20Ali	female
medhat86	male
media	male
medmed	unknown
medo	unknown
Medo	male
Medo.13	male
medo1357	male
Medo2000	male
medo.ibrahem	male
Medoka	unknown
medomohab	female
Medoo	female
medoobad	female
medooo	female
Medoooz	unknown
medosh	male
medosora_82	female
medotoyota	female
MeedoZ	unknown
meeesaaa	female
meeka31101988	female
MeemoFloyd	male
Meero901	male
mega	male
mega156	unknown
mega33	unknown
megaa	unknown
megimas	unknown
mego	female
Mego01004053564	male
mego_100	female
mego2015	male
megoooo	male
MEgoOoz	unknown
Megs	unknown
meguid	unknown
megz	male
Meho	unknown
meho157	unknown
meido	male
Mekkawy	female
meko	unknown
Meky	unknown
Meladl	unknown
melalfy	unknown
melashry	unknown
melessy	unknown
melfangary	unknown
M.ElFouly78	female
MELHABIBY1	male
melhiny	unknown
melissaazer	male
MElKady	unknown
melkordy	unknown
Melmasry25jan	unknown
melmiligui	female
m.elmiligy	female
melmoghany	unknown
melmouzy	male
melosiely	male
M.elrefaey94	male
MElsabaa	unknown
melshamoty	unknown
melsherbiny	female
melsherif	male
melzoam	female
M.Emad	female
meman010	unknown
Memary	unknown
meme	female
memex	male
memo	male
Memo	female
Memo777	female
memo87	female
memoo	male
memoo_come_back	male
men3em	female
mena	unknown
Mena	female
menakazamiza	male
mena.mohsen	female
Menan	female
menan22	female
menemyar	male
menena	male
menessi	male
menna	unknown
Menna	unknown
mennabekheet	male
mennagam	female
Menna.M.Khalil	female
mennaruchdy	female
mennatallahW	unknown
mennatayaad	female
mennon	female
meno	unknown
MeNo	female
Menyawi	unknown
Menyawy	male
mera20092009	male
Meraba	female
meramez	female
mercedes	female
mercurious	female
meriammaher	female
mermaid.mero	female
Merna	female
mernasalama	female
mero	female
mero0o0o	male
mero902000	female
meroo	female
meroo_basha	male
merooo	male
merosh	male
meroslave	female
Merry	male
mervat	male
Merwech	male
meseery	male
meshmesh	male
meshmesha	male
_meshreki	unknown
messi	female
Messi	male
m.essmat	unknown
Mest3gl	unknown
metalhead	unknown
Meto0o	male
meto33	unknown
Metovam	unknown
metozz	unknown
metsho10	unknown
metwally	unknown
Mexcano	male
mexy2310	female
mezo	male
Mezo	unknown
Mezo.86	male
Mezo88	male
mfadl2011	male
mfaioumy	male
m.farouk	female
mfifi	female
mfouad91	male
m.fthy	female
mfyk	male
MG	male
MGAMAL93	unknown
Mgameen	male
mgebaly	unknown
Mgendy3	unknown
mghoneam	unknown
MGM	unknown
Mgohar	unknown
M.gomaa	unknown
mguissouma	unknown
m.h	unknown
mhabib11	male
mhaddad	male
m.hadidi	male
mhakam77	male
mhamaky	male
mhamdy74	male
M.Hammad	male
mhany	unknown
m.Hasan	male
MHatem85	male
m.helal	male
M.Heliopolis	unknown
mhf	male
mhhafez	male
MHHH	male
mhmd	male
Mhmd	male
Mhmdfrg	unknown
mhmdkotop	male
Mhmmd	unknown
mhmodelbakry	male
MHMR	unknown
m_hoshy	male
MHosny	male
M.hossam	female
MH_Rashed	female
mhsa89	female
mh.siam	male
MhusseInabdou	male
M.Hussien	male
mhzedan	male
mi5aaaa	male
mibi	male
m.ibrahim88	male
michael	male
Michael	male
michaelayad	male
michael.ibraam	male
MichaelMix	male
michaelthomas	female
Michail	male
micheal	male
michel	male
Michel	male
michelassaad	male
Michelle	male
michelphilip	female
michita	male
Micho	male
Michoomorg	female
Micke	female
mickey	female
mickeytab	female
micoairforce	female
mid0oo0oo0	male
midioo	unknown
mido	female
Mido	unknown
MiDo	male
MIDO	female
Mido007	male
mido1934	unknown
Mido321812	male
mido7oda	male
mido8266	male
mido83	male
mido91111	male
Mido:D	unknown
MidoDu	unknown
midokhater	male
mido_kimo_love	unknown
midomedia5	male
Midoonline	unknown
MiDoOoOoZ	male
midooos	female
midooothomas	male
midosaido	male
Miekhster	male
MIF	male
MiG	unknown
MightyMido	male
migo	male
Migo	male
Migou	male
migzy	male
mika21	unknown
Mika30	male
mike	male
Mike	male
Mikhail	male
mikman	male
Miko	male
Miko2000	female
Milad.toty	female
Milanovich	female
milt15	female
Milz	female
Mimasry	male
mimi	female
mimi23	female
Mimikaaa	male
Mimo	unknown
MiMo	male
mimog	unknown
mina	unknown
Mina	unknown
Mina%20Bishara%20Abdel-malek	unknown
Mina%20Sobhy	unknown
Mina%20Wassef	male
mina456	unknown
minabassem9	male
minaboshra	male
minafridZ	unknown
minaissac	unknown
MinaLouis	male
MinaMAdly	male
minamo7sen	female
minawagdi	unknown
minayouhanna	female
minazaherzaky	unknown
minaziz	female
Minerva.George	unknown
Mino	unknown
mino_jr	unknown
minos333	female
Minosh	female
Minou	female
Minsh	unknown
Minshoz	female
minzy	male
mira	female
Mira	female
mira172	female
mira94	male
miral	male
miramin	unknown
mirav1188	female
Mireille	unknown
Miriam100	unknown
miro	female
Miro	unknown
miro_00	female
miro003	male
miro12345	female
Miro17	male
miro2013	male
Miro411	male
mirooo	male
Miro_style	unknown
misha	unknown
misho	female
misho0o0o0o0o0	female
Misho76	female
mishue77	unknown
mismael	male
MIsmail	male
miss	male
Missi	unknown
miss_mira22	unknown
misso911	male
mistafa	male
mizo	female
Mizo	female
mizosabry	unknown
mjgjizzy	female
mjjffgggg	male
M.Joe	male
mk	female
MK	male
M.K	male
MKaboudan	male
MKamel	unknown
mkamelmou	male
mkamelooo	male
mkem	male
mkhattab2010	male
M.Kheidr	female
Mkhiary	male
mkjb	female
mkommos	female
mlatif	male
mlf	unknown
Mlinza	male
MLM	male
mlsf_lanos	unknown
mm8001103	male
mma8408	male
mmady	male
M.Mahmoud	male
m.mahran	male
m.maziad	male
mmc	male
MMCH	male
mmf985	male
mmfi	male
M.Mizo	male
mmk	male
mmkader	male
MMKamel	male
MMM111MM	unknown
mmmb	male
mmmm1234	male
mmnagui	male
mmoneim	male
MMoneim	male
mmonem	male
MMontash	female
mmoro	unknown
M.Morsi	female
M.Mosaad	male
mmsasufe	female
M.Mujeeb	male
m!na	male
mnader1	female
mnaga	male
M.Nasser	male
MNEODNPA	male
m.nessim	male
mnoorlove26	male
mnshafei	male
mo	female
Mo	female
mo0ody	female
MO%20S%20TY	male
mo2men.haroun	male
mo2ness	male
Mo3	male
mo3aaz	male
mo3geza	male
mo3taz	male
mo3taz_refai	male
mo7amed	male
Mo7amed	female
mo7amed_ayman	male
Mo7eb	female
Mo7sen84	male
Mo7SiN	male
Moahmed	male
moamen	unknown
Moatasem	male
Moatasem%20Azab	male
moataz	male
Moataz	male
Moataz8	male
Moataz_eliwady	male
moataz_kordy	male
Moaz	male
Mo'az	male
mobelal	male
Mocha_88	male
Modito	male
mody	male
Mody	male
modyadel	male
Mody_Benz	unknown
modymoataz	male
modyrony	unknown
modyy	male
moe	female
Moe	male
!-Moe-!	male
moeayman	male
moe_fawzi	female
moekamal7000	male
Moemen	male
moemen.ahmed	male
MoE.SOLIMAN	male
mofaroha	male
Moga	male
mo.galal	male
MogGz	male
moh	male
Moh.	male
moh77.-	male
Moha.	male
moha1	male
moha20987	male
Mohaa	male
mohab	male
Mohab	male
moh.abdelmegief	male
moh_abdelraheem	male
mohabelghamry	female
Mohab_ElMohr	male
mohabesmat	male
MohabJamel	male
MohabWagdy	male
mohadel98	male
moh_aly42	male
mohamad	male
Mohamad	male
Mohamad%20Ramy	male
Mohamad%2520alassiuty	male
Mohamd	unknown
mohamed	male
Mohamed	male
Mohamed.	male
Mohamed%20Abdel%20Moniem%20Ali	male
Mohamed%20Aboalftouh	male
Mohamed%20Ahmed%20Ramadan	male
mohamed%20ehab	unknown
Mohamed%20Elabd	male
Mohamed%20Elkholy	male
Mohamed%20Elmalla	male
Mohamed%20El-Nokaly	male
Mohamed%20Essam	male
Mohamed%20Farouk	male
Mohamed%20Fathy	male
Mohamed%20Fawzy	male
Mohamed%20Gad	male
Mohamed%20Gamal%20Haggag	male
Mohamed%20Hagag	male
Mohamed%20Hany	male
Mohamed%20Helmy%20Abo%20Eita	male
Mohamed%20Hosny	male
Mohamed%20Khlil	male
Mohamed%20Nabil%20Ghoname	male
Mohamed%20Nawar	male
Mohamed%20Ossama%20Gawish	male
Mohamed%20Sabry	male
Mohamed%20Seif%20El-Din	male
Mohamed%20Yousef	male
Mohamed%20Zakaria%20Ziko	unknown
mohamed3mad	male
mohamed77777700	male
mohamed7amed6719	male
mohamed81	male
Mohamed.abdelmoneim	male
Mohamed.abd.elwahab	male
Mohamedakram88	male
mohamedalaa	male
Mohamed_ali1234527	male
mohamedali_ma	male
MohamedAmr74	male
mohamed_anwar	male
Mohamedashour	male
mohamed_ashraf1995.	male
mohamed_atef	male
Mohamedattar	male
MohamedA.Ziz	male
Mohamedbadr	male
MohamedBadr	male
MohamedBander	male
mohamedbbt	male
MohamedBelal	male
mohameddawood89	male
mohameddweek	male
Mohamedeid	male
mohamed.el	male
mohamedelalfy	male
MohamedElgamel	male
mohamedelgendy	male
mohamedelhageb	male
mohamed.elhariri	male
mohamed.f	male
mohamed.fadel	male
mohamed.fahmy	male
mohamedfarouk12	male
mohamed.fathi590	male
mohamedgad1981	male
mohamedgalal	male
MohamedGhonamy	male
mohamedhalimomar	male
MohamedHamdyHafez	male
mohamedhassanein	male
mohamedhendawy	male
mohamedhneid	male
Mohamed.hussein	male
mohamed.ibrahim	male
mohamedismael	male
Mohamed_kh	male
mohamedkolib	male
mohamedmac	male
mohamed_mahdy	male
mohamedmarwan1983	male
MohamedNagy13	male
mohamednaser84	male
Mohamed_Nezar	male
mohamed.omar	male
Mohamedouf9	male
Mohamedoze	male
mohamedrani	male
MohamedRedaaa	male
MohamedRef	male
mohamed.s	male
mohamedsaad	unknown
mohamedsaeed	male
mohamedsalama	male
mohamedsaleh145	male
mohamed_salem	male
Mohamed_Samir	male
mohamed.samir.saleh	male
mohamedsamy	male
Mohamed.yehia	male
Mohamed.Yeia	male
mohamef	male
Mohammad	male
mohammadbakr	male
mohammed	unknown
Mohammed	male
Mohammed%20Ibrahim	male
Mohammed%20Mostafa%20Ahmed	male
Mohammed%20Taha	male
Mohammed%20Yassen%20Shalaby	male
mohammed.farouk	male
MohammedFathi	male
MohammedGad	male
MohammedGamal	male
Mohammedhelaly	male
mohammed.helmi	male
mohammedhelmym	male
Mohammed.mosaad	male
mohammednagi	male
Mohammohmed	male
mohanad	male
Mohanadahmed	male
MohanadElmorsy	male
mohand	male
mohaned	male
Mohaned	male
Mohannad	male
moharram	male
mohassan	male
mohassem	male
Mohd	male
mohehabessa	male
mohemed	male
moh.fadly	male
mohghaly	male
Moh.Helmy	female
mohhim	male
moh.h.salem	male
moh.hussein	male
mohid	male
Mohie	male
MOhita	male
Mohkassem	male
mohmad	male
mohmed	male
Mohmed	male
mohmeda022	male
Mohmeed	male
mohmmed	male
Mohmmed	male
mohmok	male
Moho_79	male
mohsaid	male
Moh.Salah	male
moh.salem	male
mohsen	male
Mohsen	male
Mohsendent	male
Mohseneto	male
mohsen.hamza	male
mohswailum	male
mohsyen	female
moh_tarek	male
Mohy	male
mojito	male
Mok	male
moka	female
mokalila	female
mokh	male
mokheekh	male
mokht	male
Mokhtar	female
Mokka	female
Moksha	female
mola	male
moldova1	male
molii	male
molly	male
Molly	male
Molly23	female
Mollyjojo	male
molto	unknown
mombeeh	male
momeh	female
Mo'men	female
Momen%20Yhia	female
MoMeNGhAzAl	male
momenSh	male
Momentoooo	male
momo	male
Momo	male
MoMo	female
momo44	female
momo78	female
momome	female
momorere	female
MoMy	unknown
mona	male
Mona	male
Mona%20Shurrab	unknown
Mona22	male
MonaA	male
monaas	male
mona.elmorsi	male
monagouda	female
monamdarwish	female
moneeb85	female
monem	female
Monem	female
mongy	female
moni5789	male
monica	male
moniem	male
Moniem	male
Moniicanag	male
Monika	female
monir	male
Monir	male
moniz	male
monmon	male
Monmon188	unknown
monny73	male
Monooshsh	female
monr	male
mons	male
monsssss2000	female
montaser_ebeid	unknown
montasser	male
Monto1983	male
monty	male
Monty	female
Mony	male
monyseif	male
Monzer	male
monzi	female
monzy	male
Moo	female
Moodi	male
moodster	female
Moody79	male
moody828282	male
Moomz	male
moon	male
moonbeam	male
Moons	male
moontower19	male
moony25	male
mooody88	female
mooooh	female
mooooooo	male
mooooooooo18	male
Moos	unknown
moos76	male
mora	male
Mora	female
morad	unknown
morali	male
Morcos	male
Mordi	male
mordy185	male
morgan	unknown
morgan_83	male
Moriano	unknown
moro	male
Morooo	male
mos	female
Mosafer	female
mosama	male
mosbeto	male
mosco	male
mos_elshenawy	male
mosheera	male
Moshira	male
mo.si2002مدحت	male
moslem	male
MoSoli	male
mossaad	male
most	unknown
Most	male
most626	male
mostafa	male
Mostafa	male
mostafa02020	male
mostafa0farouk	male
Mostafa1	male
Mostafa%20Abo%20Ahmed	male
Mostafa%20Abou%20El%20Nasr	male
Mostafa%20Amr	male
Mostafa%20Elseidy	male
Mostafa%20Gaber	male
Mostafa%20Gad	male
Mostafa%20Hasnen	male
Mostafa%20Hussein%20Aboraya	male
Mostafa%20Ibrahim	male
Mostafa%20Marwan	male
Mostafa%20Mohamed%20Attia	male
Mostafa%20Salah%20Eldin%20Zaky	male
Mostafa%20Sho%C8%9Caib	male
mostafaaaa	male
mostafa.algohary	male
mostafa.ali	male
mostafaaly86	male
Mostafa.B	male
mostafaelrouby	male
Mostafa.Elseidy	male
mostafa-elsharkawy	male
mostafaf139	male
MostafaHanafy	male
mostafa.haridi	male
Mostafa.m	male
mostafamahmoud	male
Mostafa.Megahed	male
mostafasamir	male
mostafashalaby1	male
Mostafa_Soud	male
mostafa.tammamm	male
mostafa.tawfic	male
MostafaVoldo	male
Mostaga.Helmy	male
MoStApHa	male
Mosta_RM	male
Mostic	male
mostkholy	male
mostmedhat	male
mostolix	female
most.R	male
mota	unknown
motaz.aziz	female
motaztarek	male
motb	male
Moto	male
moud109	female
moudi	male
Moudy	male
mou_fayed	male
mounir	male
Mounir	male
moura	male
mourad	male
mourad182	male
mouro	male
mouryyy	male
moushicat	male
Moussa	male
moustafa	male
Moustafa	male
moustafabdo	male
moustafa.elsaban	male
Moustafa.habashi	male
moustafa.mahmoud.sew	male
MoustafaShalaby	male
Moustapha	male
moustapha_h	unknown
Mousti	male
Mouta	male
moutaz	male
Moutaz1979	male
MoYoMo	male
moza44	male
Mozartian	female
mozt	male
mozy	male
mqersh	unknown
mr	male
Mr	male
mragab	male
m.ramadan	male
mraouf1	male
Mr.Dandy	female
mrdy01144476667	unknown
mrefaateng	female
mrefaie	female
mretsh91	male
Mr.Forever	female
MrGeo	male
mr.h	male
MR.Happy	male
Mr.Luka	unknown
Mr.Oracle	male
Mrs.	male
mrsbeggo	female
Mrs.Nanou	female
Mrs.Penguin	female
mrs.shady	male
mr.tamermamdouh	male
Mr.VeLoO	male
ms	female
Ms	male
MS	unknown
msa.89	male
msaad	male
M.Saad	male
msaafan	male
M.SADIK	male
Msafer	male
M.Said	male
m.saied.89	male
M.Sakr	male
Msalah.hussein	male
M.Salash	male
m.saleem	unknown
msaleh641	male
msam	male
M.Samee	male
msami66	male
msamirali	female
MSamra	unknown
M.saoud	male
M.Sayed	male
msayed3	female
msaziz	male
Msedky82	male
mselim	unknown
M.Selim73	male
mshaf3y	male
mshafei	male
mshak	male
M.sharawy	male
m.shehata	male
Ms.Hendi	female
M.shereef	male
m.sherief	unknown
mshmsh	male
MSH.MSH	male
mshoukry87	male
m.sico	male
M-Siddek	male
Msmok	male
MSN	male
msobhy1	male
M.Sobky	female
msokromy	male
Msoliman	male
Mszakaria	unknown
Mt	unknown
Mtaha4000	female
mtarek93	female
mtawfik20	male
mtk	male
Mtmih	male
mtmoscout	female
M.Tolba	male
MTurk	female
MTZ1981	female
Mu	male
MuaD	male
mucf80	male
muchianoo	male
mucho	male
mugemzo	male
muhamd	unknown
muhamed	male
Muhamed	male
MuhamedMustafa	male
muhammad	male
Muhammad	male
MuhammadAbdelhalim	male
muhammad.a.rahman	male
Muhammad-bakr	male
MuhammadNour	male
Muhammad.S.Sayed	male
muhammed	unknown
Muhammed	male
Muhammed%20Salama	male
Muhanad	male
Muhanned	unknown
muko1000	unknown
MuskeTeeR	male
mustafa	male
Mustafa	null
mustafa_hussein	unknown
MustafaMAmin	male
mustafa_zaki	unknown
Mustapha	female
mwahch	male
m/wessam	male
mwsharawy	male
mwzaki	male
m.y	female
MY	unknown
m.yacoub	male
m.yasser	female
m.yehya44	female
myossry	male
Myriam	unknown
myrnaghanem	unknown
Myway	male
Mz	unknown
MZ	male
mzakaria	female
mzanaty	female
mziad	male
m.zizo75	male
N	male
Na2o0ol	male
Na3na3a	male
naa	unknown
Nabawy	male
nabawysky	male
Nabawyz	male
nabhan	male
Nabi	male
Nabihdarwish	female
nabil	female
Nabil	female
NABIL	female
Nabilfayz15	female
nabilsahlab	female
nada	female
Nada	female
Nada..	female
nada1989	female
nada_23	male
Nada30	male
nada8787	unknown
nada89	male
nada91	female
nadaa	unknown
nadahamdi	male
NadaHussein	male
Nadamafattah	male
nadamawhob	male
NadaSaad21	male
nadatawfik	male
nadausama	male
Nadeem	male
nadeer	male
nader	male
Nader	male
nader1818	unknown
Nader86	male
naderelfaky	female
naderexx	female
naderious1	unknown
Nadim	unknown
nadimgalal	female
nadin	female
nadine	female
Nadine	male
nadine1	female
nadine21789	female
nado	male
Nado	male
nadood511	male
nadoode2dew	female
nadooora	male
Nadosha	male
nadrazaki	male
nadu	female
N.A.G	male
nag3awee	male
nagaahmed	female
Nagdy	male
Naglaa	unknown
naglaan	male
naguib	male
Naguib	male
nagwa	female
Nagy	female
nagyshalaby	female
nahalaa	female
nahaniso	male
Nahed	unknown
NahedAzab	female
nahla	unknown
Nahla	female
Nahnoha	male
NahomGPS	male
Nahoula85	unknown
nair	unknown
Nairouz	female
Nakeeb	unknown
nakhlazzz	female
nakkash	female
Nama1	unknown
namanemo	unknown
Namira	female
namous	female
nana	male
Nana	female
Nanc	female
Nanceeko22	unknown
nancy	female
Nancy	female
nanishassan	female
Nannie	female
Nanno	male
Nannto	unknown
nanny	male
nano	female
nanou	female
Nany	male
Napester	male
nardinefarag	male
nardine.nabil	male
narmar66cool	male
narraya	female
NASH	female
nashaat2828	male
nashar	male
Nashnoush	male
nashraf	male
nashwa	male
Nashwa	male
nasr	female
nassar75	male
nassef	male
Nasser	female
natshoooooz	male
navigator19eg	male
Nawar	male
nayeb	female
Nayer	male
Nayoor	male
Nazmy	female
nbadarn	unknown
Neamat	female
Neboo	male
necrocyte	male
nedal	male
neeen	male
Neffertary	unknown
nefo	unknown
Nefsi	female
negm	unknown
Negm6600	male
Nehadsalem	male
nehal	male
Nehal	unknown
Nehal82	female
nekh	unknown
nellzy	female
Nelridi	male
Nemo	male
nemo6267	male
Nemooo	male
Nemsk	female
nendiii	female
neno	female
Neno	unknown
Neo_Matrix	female
NEPPOO	female
Nerm	female
nermeen	female
Nermeen	unknown
Nermeen1	unknown
Nermen	male
Nermin	female
nermine	female
Nermine	male
nermish	male
nermo	female
nermohn	male
nesma	female
Nesma	female
nesmaelshazly	male
neso	male
nesr	male
nesrienomar	unknown
ness	unknown
nessma	male
nesta4	unknown
Nestawy	male
NetLoader	male
nevineelshiaty	male
nevo-87	male
nezar	female
N.G	male
Ngallad	female
NGB	female
nhjmn	female
nhussein	male
nice	male
nicee	unknown
nido	unknown
niemo	male
nigo	male
nihal	male
Nihal	female
Nihal0812	female
nihal666	female
Nihal.elsaid	female
Nii	female
Nilly	male
nimetta	male
Nina	unknown
nini100	unknown
NinooOoo	unknown
ninozahran	female
nironiri	unknown
Nissan78	unknown
Nisso67	female
nisterloy	male
NIVO	male
N.kadi	female
nKATA	male
nkholy	male
NM3	unknown
NMK	male
nmohsen	male
nmostafa83	male
NN	female
nnaguib	male
nNasr	female
nnofal	male
no	unknown
nobel2020	unknown
Nobie	female
noda75	male
Nodazamalkawya	male
nodout29	unknown
Nody	unknown
noflow	unknown
noga	unknown
noga1981	female
NogNog	male
noha	unknown
Noha	unknown
Noha139	unknown
noha2s	unknown
nohaaa	male
nohaaboeleoun	male
Nohaatef88	female
Noha.Elzanaty	female
nohahashem	female
Nohanoo	male
Nohasoliman	male
Nohatelo	female
nomy	male
nona	female
Nona	female
Nona2921	female
nona84	male
noname2013	male
noname77	unknown
nonaz	female
Nonetsa	unknown
NonnaNosha	male
Nonnus	male
nono	female
nony	female
Nonyza	unknown
NonzNag	female
noodile	unknown
nooge	female
Nooj	female
NooN	unknown
nooonie	unknown
nooons	female
noooo	unknown
noor	female
Noor	male
nooshass	female
nooz2011	female
nora	female
Noramoe	male
Noran	male
Noran%20Sabry	male
Norane	male
Norhan	female
norhanb	female
nosa	female
Nosferatu	male
Nosha2011	male
Noshoqaty	unknown
Nou	male
Nou2a	unknown
nou2nou2	female
noudy	male
noukii	male
nouna4469	female
nounasaid	female
Nounie	female
nounies	female
nouns	female
nouny	male
nounza	female
nour	male
Nour	female
NouR	male
NOUR	male
Nour%20El%20Effendi	unknown
Noura	male
Nouraldinho	male
Nouran	male
nouran1988	female
Nouran2212	female
nouraslan	male
nour.ebid	male
noureldin	male
nouresm	male
nourhan	male
Nourhan	male
nourhan80	male
NourhanHossam	male
Nourhanne	male
Nourr87	male
nourrzz	male
Nourshan	unknown
Nourza	unknown
nowayout	male
NS	male
nsabry	unknown
N.Saleh	male
nsharaby	male
nsobeih	male
nudz	male
nukin	male
(null)	male
nunii	male
nunu	male
Nur	female
nurinojeil	unknown
Nutshell	male
Nyazy	unknown
nyoussef	male
NZaki	male
nzee	male
O	male
oakamal	male
oarnaouty	female
oayms	male
obaidoz	female
Obide	unknown
octane	male
octoberawy	female
Odba	male
odddddy	unknown
o_deeb	unknown
O.elgedawy	female
Oessam	female
oflot83	male
Oi1	female
O.K.	male
okaby	male
Okda	male
Ola	male
OlaGhandar	male
Olakhorshid	female
ola.mohamed.yousry	female
Olfatabdellatif	male
oliver	female
ollaa	male
oly	male
om	male
Om	male
omaarrahmeedd	male
OmAmina	male
omar	male
Omar	female
omar12354	male
omar131313	male
Omar%20Fuad	male
Omar%20H.%20El-shamy	male
Omar%20Hossam	male
omar27	male
omar94	male
omara007	male
omarabotera	unknown
Omar.adel	male
omaradel_1304	male
omarahmed	male
omar.alfar	male
Omaramgad	male
omaranasr	male
omararft	male
omarbadra	male
OmarG.	male
omargar7y	male
Omar_Hadidy	male
Omar_Hassab	male
omariano	male
omarion	male
Omariooo	male
omar.k	male
omarlawendy	male
OmarM	male
Omarmum	unknown
Omar_Nouh	female
OmarQadry	female
omar_the_13	unknown
omarwalid	female
omarzday	male
OmAsmaa	male
Omda	female
omda2013	male
omeligi	female
Omima	female
omlaila2010	unknown
omloli	male
Omneya	unknown
Omneya.abdalazi	unknown
omnia	male
Omnia	male
Omniar	female
OmnyaImad	male
omran2311	male
omSaif	male
Omzy	female
on	female
oneway2012	female
Only	female
only3asem	female
o.onsy	unknown
Oousha	female
opel	unknown
Opera	male
operation15	male
Ophelia22	female
Opium	female
opra	male
Oreo	male
orkando	male
OS	male
osa	male
osaka_33	male
osama	male
Osama	male
osama2013	unknown
OsamaAfifi	male
osamafayed	male
OsamaMagdy	male
Osama.Naiem	unknown
OsamaRamy	female
osamra	male
OSAMY	male
Oshosh79	male
osman	male
Osos	male
Ososbasha	male
ossama	male
Ossama	male
ossyyy	male
ostaz	male
Ostaz	unknown
otto	male
otttty	male
oudy	female
Oudyy89	male
oufa78	male
Oufaaa	male
Oufoo	male
ousa	unknown
ouzaazouza	male
ouzynkoki	male
Ovi	unknown
owf88	male
ox	unknown
oxyproxy	female
oyousry	male
oz	female
oze	female
Ozmoziz	female
ozzyy99	female
P2	male
pacinthe	male
pakinam	female
Pakinam	female
Paky1972	female
paollo13	male
Passant	female
past1817	female
patagonya	female
patchiii	male
Patro	unknown
Paul	male
paula3atef	male
pearlerboy	female
pearly	unknown
Peer	unknown
pelgohary	female
Penguin	female
pEpO	male
pepsi	male
pepsii	male
Pepsii	male
peri	male
Perihan	male
peter	male
peTer	male
Peter	male
Peter7000	male
Peter911	male
peterfarag	male
peterfayezpeter	male
petergamalPG	female
peter.salama	female
petersamirzaki	female
Peterson81	female
Petro	unknown
petro_eng	male
petty	male
Phantooo	male
phaosi	male
Pharmacist	male
phondama	female
pico	female
Pierre	male
pilot	male
Pilot	male
Pilotengineer	male
pinkscoush	male
pinky26	female
pinkycat	female
pipo	male
PM	unknown
p.n.elmasry	male
Poda	female
pola	male
Pola	male
polo	female
poohpoohtata	unknown
pop	female
pop....	female
popman	male
popo	male
popoowahba	female
popstar	male
pordo	male
Posposa	male
posycat	unknown
Potros	male
Pregoo	male
prince	male
Prince	male
princessmiro	male
Princess_Semsema	male
production	unknown
Prof89	male
ProfessorNemo	male
prof.more	female
profnabil	unknown
PS	male
Psnake	female
psycho	unknown
pukinam	unknown
Puma	male
Pyohanna	female
pyro	male
Qellawi	unknown
qksaif	male
queenroushy	female
queen-siham	female
quickraven	male
qwerty11	female
R	male
r00ni	female
R92	female
ra	male
Ra2fat	male
ra2roo2a	male
Raafat	female
rabab	female
Rabab	unknown
Rababo	male
rabie	unknown
Racer	unknown
radwa	male
Radwa	male
radwamohie	male
Radwan	male
radwan12345	unknown
Radwanco	unknown
RadwaRashad	male
Rady	male
Raed	male
RaEf	male
raf3i	male
Rafarafa07	male
Rafeek	male
rafek	female
Raffaele	unknown
Rafi	female
rafik	female
Rafik	male
rafy1971	male
Ragab	male
Ragab15	unknown
raghda	male
Raghda	female
raghda66	female
ragheed	male
ragi.mahmoud	male
raguibadie	unknown
ragy	male
rahma	male
Rahma	male
rakan	unknown
Ramadan	male
Ramadan_13	unknown
rameahmed	male
ramez	male
Ramez	male
Ramez.I	male
ramezkamal	female
ramezmekhail	male
RamezWezza	female
rami	male
Rami	male
Rami%20Makled	male
rami_araies	unknown
ramicassis	male
RAMIFLIES	male
RamiGuindi	male
Ramiii.gamal	male
ramiktatny	male
Rami.M.darwish	male
Rami.Saladin	male
ramiwahbi	male
Rammoha	male
Ramos	unknown
ramy	male
Ramy	male
Ramy.19	male
Ramy%20Assem%20Sherif	male
Ramy.Abol.Fetoh	male
Ramy_Antar.	male
ramyemam	male
ramygabr	female
ramy.philip	male
RamyR	male
ramyr7	male
ramysafwat	male
Ramyscorb	male
ramysultaan	female
ramyvadel	female
Ramyy	female
Ramyymoustafa	unknown
ramyz	unknown
Ramzy	male
rana	female
Rana	male
R-ana	male
rana89	female
ranaelnaggar91	female
ranamrmohamed	female
RanaRadi	unknown
ranasaad	unknown
RanaZaki	male
randa	unknown
rania	female
Rania	unknown
raniad11	unknown
Rania.elsayad	unknown
raniashafik	male
rannnoushy	male
Rano	male
Ranoosh	male
Rany_Motawie	male
Ranzzz	male
raof	male
raoof	male
raouf	male
Raouf	male
Raouf%20Rafla	female
Raoufash	female
raptor	unknown
rara1975	male
rara87	unknown
ras	unknown
rasha	male
Rasha	male
rasha456	male
Rashaad	male
rashabadawi	male
Rashahome	male
rashamohssen	unknown
rashasalem	female
Rashed	male
Rashidi	female
rashidy	male
rasmy	male
ratata	male
rawan	male
Rawda07	male
rawna	female
Rawya%20Abd%20El%20Hamid	male
RawyYoussef	female
Ray	male
raymond	unknown
razakof	female
razish	female
Razy	female
R.Candy	unknown
R.dadlz	male
Rdayoub	male
Re3oo	male
Ream	male
Rebel	female
RebelliousAhmed1	female
reda	female
Reda	female
Redarrowes	female
Red_berry	female
Ree	female
Reeeha	unknown
reeemmoz	female
reeemoz	female
Reefo	female
REeham	female
reeka	female
reeka77	male
reem	unknown
Reem	unknown
reem_22	female
Reema%20Rayan	male
reemakl96	male
Reeman	male
reemeltawil	unknown
reemfawzy	female
reesha	female
ref3at	male
refa3y	male
refaatse	male
Regz	male
rehab	male
Rehab	male
Rehabhamza	unknown
reham	male
Reham	male
RehamHesham	female
rehammostafa	female
reko	unknown
Relebiary	male
Relghannam	male
Relshalakany	male
ReMa	male
Remaaa	unknown
remarady	male
remeo	male
Remmygalal	female
remo	male
Remo	male
remok	male
remon	female
Remon	male
remy72	male
Remy9	female
rengo	male
Reporter	male
Resho%20Ganini	male
reweima	male
rezo007	male
RHania	male
Rhany	male
Riad710	male
rico	male
rico82	male
rico86	male
ricokiko77	female
ricoz	unknown
RIDER	female
rih	male
riham	female
Riham	unknown
rihame	female
RihamElkomy	male
riko	unknown
riko481	male
rimo's	unknown
rishoo	unknown
Rita	unknown
River	female
RIZKALLA	unknown
Rizo911	unknown
rjy	male
rkahla	female
RMAC	male
rmbtoj	male
rmensho	male
RMorsy	male
ro0o0dyy	male
roaa	male
road	female
Roaddog	female
road_rider	male
Roadrunner	male
roadseeker	male
Roar	male
roba	male
Roba	male
Rober	male
robert	male
Robert	male
roberto	male
Rocky	male
Rocky12	male
Rocopoco	male
Rodiger	male
RodyNRoky	male
rofa007	unknown
rogee	female
rogerwaters	female
Roggs	male
Rojy	female
roka	male
Roka164	female
Rokaaz	male
Rokaya	male
Rokayya	male
Rola	male
rolls	male
roma	male
Roma-7	male
romarior82	female
Romeo	male
romeo_elhayes	female
RoMeOoOoO	male
Romik	male
Romio	male
Romio12	male
Romoz	male
Ronda	male
RonnieAdham	male
ronon	male
Rony	male
Rony***	female
ronyyoyo	male
ronzy1	male
roo	male
roody	male
roofyyy	male
Roona	female
Roongo	male
Roony	female
RooNzzz	female
rooo	male
roro	female
roro123	unknown
Rory	unknown
Rose	female
rosha	male
Roshdy	male
Rou'a	unknown
roua2008	male
roudeny	male
rouga	male
Roui	female
rouka_18	unknown
Rouriiii	male
rourou	male
rourytako	unknown
Rousham	unknown
Roushazeina	unknown
roushdy	female
roushdyseoud	male
row	male
Rowaida94	male
RowaidaMoh	male
roza_rizkalla	male
Rozza	male
RP	female
rramadann	female
rsarhan	female
R.S.E	male
rsh	male
RSN	male
rubbela	male
ruby	female
Rudiii	female
rudy	female
RUF	male
ruler	female
Rupert	male
rush_hour	male
Ruty	female
rwrw93	unknown
ryazeed	unknown
Rym	unknown
Rym%20Abdel-Aziz	male
RYO	female
RYOoO	male
s	male
S	male
S.	male
s7s	male
sa3aza	male
Sa3d	male
Sa3d-878aaa	male
sa3doon	male
sa3ed	male
Sa3ed	male
sa3eed	male
saad	female
Saad	male
saadoka	male
saadon	male
saad.shaker	male
Saaed	female
Saafan	unknown
s.a.b	male
sab3awy	male
Sab3elbromba	female
Sabant	male
Sabba7	female
sabbahy29	female
Sabdelaziz	male
Saber	female
sabet	male
S.Abouzeid	female
SaBRiaNoo	unknown
Sabrico	male
sabriiiz	male
Sabrouty	male
sabry	male
Sabry3000	male
sad4umasr	female
Sadany	female
Sadek	female
sadevil	female
saeed	male
Saeed	male
saf0rya	male
Safa	female
safaa	unknown
Safaa	unknown
safauss	male
safey	female
saffay	female
Saffy	male
s.afify	male
Safina24	male
Safiology	female
Safroot77	male
Saftoot	female
Safwan	male
safwat	male
Safwat	female
safwatahm83	female
safy	unknown
safy270	unknown
saged	unknown
sagheer	unknown
sahar	female
Sahar	female
sahar.elghooneny	male
sahargool	female
saharkhamis1	female
saharsrabie	male
saher	unknown
Saher	male
saheraziz	male
Sahlol	male
sahoora	male
said	female
saied.marey	unknown
Saiedshaawa	male
saif	male
Saif	male
S.AKabesh	male
SaKKout	male
sakoury	male
Sakr	male
sala7elgenny	male
salah	male
Salah	male
salah32	male
salahafifi	male
salahamer	male
salahb	male
Salahista	male
salam	male
salamahalem	male
salama.karim	male
Salamekka	male
Salam_Ya_Sa7be	unknown
salazo	unknown
Salbert	male
Sale7	male
saleh	unknown
Saleh	female
Saleh111	female
saleh153	female
salem	female
Salem	unknown
salesman1	unknown
Salim2	male
sallouka	female
sally	female
Sally	male
SallyEl-Qabanny	female
sally.elshahaby	male
sallynabil	male
salma	male
Salma	male
Salma%20Tarek	female
Salmahana	female
SalmaMKhalil	unknown
salman	female
Salman	unknown
salmasamer	female
Salmats2al	female
salmazzz	female
salmoosh	female
Saloohaz	male
saloom	male
Salwa	male
SalwaSalwa	unknown
Salwetta	female
Saly	female
sam	female
Sam	male
sam221269	unknown
sama.elgohary	female
samah	male
Samah	male
samaketa	male
samalex	unknown
samanoudi	male
samansa	male
samanwar84	male
samar	male
Samar	male
Samar.	male
SamarJoe	female
samasem	male
sambo	male
same	male
Same7	male
Sameeh	male
sameera	male
sameh	unknown
Sameh	male
Sameh%20Mansour	male
Sameh%20Omar%20Samehomar	male
Sameh3ali	male
Sameh574	male
Sameh.Attalla	male
sameh_elsergany	male
SamehEmeel	unknown
sameh.fillys	male
Samehmongy	male
samehmousa	female
samer	male
Samer	male
samer.j	female
sami	male
Sami	male
samia	male
samier	female
SAMiER._BENZ	female
Samiha	male
Samimourad	male
samir	female
Samir	male
Samir25	female
samira	male
samiramiss	female
samir.mahgoub	female
samisa	female
Samkiko	female
samo	male
samohas	male
SAMORAAA	male
Samou7a	unknown
samsam	male
samsung2013	female
samy	male
Samy	female
samy.abboud	female
San	female
S.A.N	female
Sanady25	female
sanasajjad	male
sandra	female
Sandra	female
sandy	male
Sandy	female
sankafola	male
sanove	female
sanshero7	female
Santa	female
santafa	unknown
sanwar82	unknown
Sapit	male
sara	unknown
Sara	unknown
sara127	male
Sara2011	male
Sara%20Ahmed%20El%20Askalani	female
Sara%20Hamouda	female
sara.abdelaty	unknown
saraelagamyelhouty	unknown
SaraElNahal	unknown
Sara.Gibaly	unknown
sarah	unknown
Sarah	unknown
sarah1983	unknown
Sarah%20Refaay	male
Sarah.abboud	male
SarahAimat	unknown
SarahAmeen	unknown
sarahbakry88	unknown
sarahelkhodary	male
Sarah_fouad	unknown
sarahghaly	female
sarahomran	male
sarahsue	male
Sarahwahba	female
Sara.ibrahim	female
sara_K	male
saramm	female
SarAshraf	female
sarhan	male
sarita	female
Sarram	male
sarry	male
sarsuur	male
sary	female
sasa	male
sasa1890	male
SaShuman	female
saso	male
Saso	female
sassa	male
Sasu	female
Satalo	female
Satour	female
saudi	unknown
Sauza	unknown
SaVaMaD	female
Saved123	female
savi	female
savioo	female
Sawaf	female
sawak	female
sawak000	male
Sawie	male
sawra	male
sawwaa7	male
sawyzz	female
saycho	female
sayed	male
Sayed	female
sayed.abdelgawad18	female
sayed.sharawy	male
sayfo	male
Saykiii	unknown
s.aziz	female
sazo7	male
sb155	female
sbadr	female
sbahaaeldin	male
SBedewy	unknown
Scapula	female
scarecrew	female
scheopet	male
scooter5000	male
Scubapro	unknown
scum	female
s.dahab	male
sdc	male
sdoss	male
se3oodyman	female
se7s	male
Se7sawy12	female
seaciso	male
seba3y	female
Seco	unknown
Sedas	female
sedawyy	male
SEEDOo	male
seeeez	female
Seef	unknown
Sehsy	male
sei3o	unknown
seif	male
Seif	male
seif92	male
seifo	male
sekobek	female
SELBaroudy	female
Seleem	male
Selim	male
sello	male
selsergany	unknown
semaaa	unknown
SeMoOo82	unknown
Semry	female
sems	female
semsem	male
semsem2006	unknown
SEMSEM7000	female
SeMsEm701	male
semsem82	male
Semsema	male
semsemz2	male
sendebad6	male
seneen	male
Sengari	male
senior	male
Serag	male
serenesirry	unknown
sergawy	male
sergyo	female
seroof	male
serry	female
ses	unknown
Sesame	unknown
sesic.waseem	male
Sesooo	unknown
sewelamovich	male
SF	male
Sfahmi	male
sgaafar	male
sguindy	unknown
Sgzaky	unknown
Sh1971	male
sh3ban	female
sh3rawy	male
Shaaban	female
Shaarawy	male
shaarawyat	male
Shadi	male
Shadia	female
shadicoo	male
shado	male
shady	unknown
Shady	male
shady10	female
shady_1313	male
Shady180	unknown
shady199	male
shady201	unknown
Shady%20Amr%20Fathy	male
Shady3	male
shady.elsedawy	male
shadyelshazly	female
shadyessam	unknown
shadygamil	male
shadymatter	male
shadynabil	male
shadyooi1	female
shadypharma	female
Shady_ramez	male
shady_sherif	male
shadytheeagle	female
Shadyy	unknown
Shaf3awy	male
Shaf3yy	male
shafey	male
shafik	male
shahd	female
shahdhelmy	female
Shaheer	male
ShahenazFouad	unknown
shaher.ayad	unknown
Shahien	female
Shahin	unknown
Shahinaz	male
shahir	unknown
shahy76	female
Shaierf	female
Shaimaa	unknown
shaimaa.saad-ramadan	female
Shak	unknown
Shakankiry	male
sHaKasHo	male
shalabawi	male
Shalaby	female
shalofa	female
shamail	male
shams	male
Shams	female
shams_beckham	male
ShamsFelTare2	male
Shanshoona	unknown
Sharaf	unknown
Sharaka	unknown
sharara	unknown
Sharawy	male
Sharif	male
Sharkas	female
Sharkawy	female
sharmy	female
Sharnouby	male
sharshabel	female
shash	female
shasha	female
shata	unknown
shawerma12	male
shawix	female
Shawkieee	female
shawky	female
Shawky	unknown
shax	male
Shaydon	male
shaymaa	male
Shaymaa	male
Shaza	male
shazly	male
she	male
She7sy	male
Shebo	unknown
shecomasry	female
shedrof	female
ShEeKoOo	male
sheekoz	male
Sheemoz	female
sheepish	male
sheerooka	male
sheery	male
Sheex	unknown
shefo79	unknown
shegary22	female
shehab	male
Shehab	male
shehab90	male
shehabonly	male
shehata	male
shehatastores	male
sheikhMohamed	male
sheiwy	male
Shekkss	male
Sheko	male
shekoo99	male
sheks80	male
shemmo	male
shemo0207	female
shemoo	male
Shemy	male
shenawy311	male
Shenawyz	female
shenn	female
shenoda	male
shenzo	male
Sherb	male
Shereef	male
shereen	male
Shereen	male
Sherhan	male
sherid	male
sherief	male
Sherief	male
sherif	male
Sherif	male
sherif005	male
Sherif%20Abd%20Elkawi	male
Sherif%20Essawy	male
sherif3abed	male
Sherif7	male
sherifakhaled	male
sherifalfy	male
sherifar	male
sherifbakry	male
sherifeisa	male
sheriffekri	male
sherifhalim	male
sherifhatem	male
sherif.Latif	male
sherifmnagib	male
sherifmohamedsoaida	female
sherifn	male
sherifnabil84	unknown
sherifnabil9	male
sherif.rabiea	male
sheriftalaat	male
Sherihan	female
sherioz	male
sheroseif	male
sherrobeak	male
sherrrrrrry	male
Sherrz	male
Shery	male
sherylu	unknown
sherzo123	female
Shesho1234	female
Shetos.safty	male
sheva77	female
Shevechenko	male
Shhosseny	male
Shicoo	female
shifi	female
shiha86	male
Shikkoo	female
shiko	female
shikohat	female
shikoo	female
shikoooo	male
shikoz	unknown
Shiksy	female
shimaa	female
Shimaa	female
shimo	male
shimoshiko	male
shimy	male
Shiref	female
Shirofahmy	male
shishi	male
Shitos86	unknown
shkassas	male
shnabil	female
shodakan	female
shoody	male
Shorbagy	female
ShorbetKhodar	male
Shorouk	female
shoshka	female
shoshoo	female
s.hossam	male
Shouman88	male
Shouno	female
shourok	female
shou-shou2	unknown
Shoushyy	female
Shreef_ehab	female
shreenmohamed	female
shrief	female
ShrOuq%20Sameh%20Elwan	female
shu	female
shukka	female
Shymaa	female
sica	male
sifo	male
sii	unknown
sika	female
Sika	unknown
Sika23	male
Sika84	female
sikalulu	male
sillyz	male
silvana	male
silverstar18	male
Silvio	male
silvy	male
simo89	male
Simon	unknown
simsany	male
simsim	unknown
simsim2014	female
simsimsim	female
singer	male
sinobino	male
sirdragon	male
Siroo	unknown
Sky	female
skyhfa	male
skyline	female
skywriter	male
slamont89	male
slawy	male
SMA	male
smahmoud88	male
smessiha	unknown
smile	male
Smiley	female
smilyyuri	male
smoharam	unknown
S.Mohsen	male
Smokesnow	male
smsm	male
smsm2111	male
smsmbahry	female
s.nagaty	female
SNashaat	female
SND	unknown
sneper	male
sniper	female
snow	male
snwnw	male
SO	male
S.O	female
Soad	female
soap	female
sobhy	male
Sobhy	male
Sobky	female
sofa	male
Soha	unknown
sohaa	male
SohaElSokkary	female
Sohaibsidkey	female
sohaila	female
Soha.Moataz	female
soharefai	male
sokkar	male
Sokkar1986	unknown
soleil	male
soli	male
solika83	male
soliman	male
Soliman	female
Solimannnn877	female
solly	female
Solly	female
Solly85	female
solo0000	female
soly	male
soly82	female
som3a	female
SOM3A	female
som3a2002	female
somaaaaaaaa	male
somaia89	female
Somaya	female
Somia	male
somsom	female
somy1	female
son	female
son3o	female
sonaqq	female
sondosabdallah	male
Sonds	female
sonia	female
sonik	female
sonos	female
sonson81	female
_sony_	unknown
Soofy	female
Sooo	male
soosooo	male
soraya	male
sorsor85	male
sosan	male
soska	male
sosovirus	male
sossa	male
sostamaw	male
Sou	male
SoU	male
souf	male
soufi	male
souka	male
soulabib	female
soulfinder	male
souli	male
Sou.Nabil	female
Souzy	male
Sparky	male
Special	unknown
speedygonzalis	male
speedyspeedy	male
Spiky216	male
squashant	male
squidward	male
S.R.	male
SRamy	male
srehab	female
ss	female
s.sam	female
s.s.H.	male
sshhiikkoo7	unknown
ssm	unknown
ssooooll	male
ssoossoo	male
SSouty	male
ssss4444	male
sstt	male
startmagic2	female
stayelegant	female
stealth	male
steelguy	male
steven	female
Stmony	female
stoma	female
street	female
su1fn	female
Su77	female
sub_ree	male
sue	male
Sue	female
Sueby2	female
suee	unknown
sukrimina	male
sullivan87	female
Sultan	unknown
sultanaz	male
Sun	female
sun_flower	female
super	male
SUPERMOST	male
super.nata	male
supernova	female
supertaa7	female
supertramp	unknown
superxero	female
surgeonahmed	female
surgeon_m	unknown
SuuS	female
suzan	female
Suzanna10	male
Suzza	male
sweetyshiry	male
swelam	unknown
sword88	female
sya	female
sylvawy	female
Symboluniquewinner	male
szohney	female
T	male
T2	male
t3bet	unknown
T3ema_A	unknown
taamer	male
taaz	male
tabymm	female
tageldin.m	male
taghreed	male
Taghreed	unknown
taha	unknown
Taha	male
Tahany	female
taher	male
Taher	unknown
taherhashem	female
Taher-M44	male
Tahiti1979	unknown
Taimour	unknown
takawy	female
taktataktak	female
Takwa	male
Talaat	male
talaats	male
Talalsh	male
talia	male
tamaro	male
Tamaty	male
tamer	male
Tamer	male
Tamer_	male
tamer1986	male
Tamer%20Elshamy	male
tamer31184	male
tamerborg	male
tamerkamel	male
tamer.m.rabeea	male
tamernaguib	male
tamerosman	female
tamersief	male
tamer.teto	male
tamertorki	male
tamervat33333	male
Tamim	male
tamora	male
tamytarek	male
Tanany	female
T.A.NASSER	male
tanta1978	male
TanTan	male
Tantawiiiii	male
Tantawy	male
tarabiza	male
tarantula1981	male
TaraP.	male
tarek	male
Tarek	male
TAREK	unknown
Tarek%20Elsawaf	male
Tarek%20Ghaly	unknown
Tarek253	male
tarek777	male
Tarek83	male
TarekBARAKAT	male
tarekbashaa	male
Tarekclick	male
tarekelfar	male
tarekeltohamy	unknown
tarekessan	male
tarekfathi	male
Tarekfouad	male
Tarek.hamza	male
tarekimi	male
tarekm.mahfouz	male
tarekmodar	male
tarektiko	male
Tarektito	female
TarekZein	male
tareq	male
Tareq	male
tareqabdelghany	male
tareqhosny	unknown
Targa	male
tariwwingrove	male
Tarlovitch	male
tarook_4	male
taroook	female
Tarouk	male
Tarraf	female
Tarro2a	male
Tary12	male
tasakr	male
tasatasa	male
Tashjewl	male
Tasnim	female
tata	female
tata246	unknown
tata89	male
TataBakry	unknown
tatamizo	male
tatef	male
Tawakolaia	male
tawdino	male
taweel77	male
Tawfi2	male
tawfik	male
Tawfik	male
tawoos	unknown
Taxello	male
Tayeby85	male
Tayr	unknown
Tayseer	male
Taz	male
TDesouky	male
tdzm	male
TE	male
tebo	male
Tee208	male
tee7a11	male
Teebo	male
teefaa80	male
Teeka	male
tefa	male
TEFA1987	female
Tefaeddy	female
Tekha007	male
Telebleb	female
Temo	male
TEMO	male
Tepho	female
Tere	female
tero60	female
tetathe1st	male
teto	male
tfahmy	male
thabet	female
thanaa	male
Thanaa	male
the	male
The	male
The_Dead_Rabbit	male
TheExorcist	female
thefm	male
Thegunner	male
the_hasn	female
TheInsider	male
the.zougz	unknown
Thorya	female
ThUnDeR87	male
thussein	male
ti5a	unknown
Ticart	male
Tiec	female
tifa	male
Tifa36	male
tifa-mostafa	male
tifos	male
tifsportif	male
Tigzzz	female
tika	male
tikifiki	male
tiko	male
Tiko	male
TiKo24	female
Tikoooo	unknown
Timmy	male
timmy7	female
Timo	male
Timonouni	male
tina	male
tinayousif	male
tipo79	male
tita	male
tito	male
Tito	male
Tito7	male
Tito74	male
tito950	male
titohussein	male
titoooo	female
titto1987	unknown
t.mabrouk	female
tmagdy	unknown
Tmh95	female
Tmm	male
to	male
Toddary	female
Tofi13	male
tofy	male
tofy82	unknown
Tohamy	male
tokaritaka	female
toktok	male
toly	male
tommy	male
Tommyikladyous	male
tomy	female
toni	male
tony	female
tonyawad	female
TonyZ	female
Tonzy	female
too7oo	female
toof	female
toola82	female
TooOooN	unknown
ToOoTa	male
Toota	male
top2	male
toqa	female
Tornado	male
Tornado85	male
Tornadoloverboy	male
tota	male
tota1990	male
tottatina	unknown
totti	unknown
Totti	male
Totti_Totti	male
touta	unknown
touta1690	male
Toxiclow	male
toz	male
Trackarazzi	female
traffic	male
Trainer	female
Travel	male
traveler	male
Troy	female
truevermo	female
TruthSeeker	unknown
TShaheen	female
tshaker	female
Tshaster	female
tsrahma	male
Tsuchiya	unknown
TT	unknown
Tucan	unknown
tugoon	male
Tuline	male
tuntun	male
Turke	male
turky	unknown
turky.2010	female
TurtleSpeed	unknown
TuUu	male
TweetyBird	male
twinmama	male
tyr15280	unknown
unique	unknown
Unknown_1111	female
unknowncode	female
uoyssef	male
Usama.Khalil	male
usamaqwe	male
user1	male
Useraya	female
usha	male
Ussama	female
ustaha	male
vagabond	female
valde	female
vam_basha	unknown
vampire	unknown
vanvan	male
vd7mmm	male
Veeka	male
Vena	unknown
venom	female
Vet.Farag	male
Viceversa	female
vico	female
victor	male
victory	male
vidovido	male
vidz	male
vina	male
violine	female
vipe	female
viper	male
VIPER_MB	unknown
virus2007	male
vodamaro	male
Vona	male
vonz	male
W-	female
W.	male
W204	male
wa2ef	male
wa2el	male
Wa73d	unknown
Waad	male
wael	male
Wael	male
WAEL	male
Wael%20Essam	female
waelabutaleb	male
waelafify	male
wael.algabry	female
waelashraf	male
waelbaha	male
wael_basha	male
waelco	male
Waelead	male
waeleissa	male
wael.elsharkawy	male
Waelezzat2003	male
WaelHamdy	male
waelhamed	male
WaelPolo	male
wafaabadr	male
wafik	male
Wagdy	female
waheed	female
wahid	male
Wahid	male
Wakeeloozz	male
Wala2hamdi	male
walaa	male
Walaa	male
Walaa_83	male
walaasalah	male
waled	male
Waled	male
waleed	male
Waleed	male
Waleed%20Mohamed	male
Waleed86	male
WaleedDerar	male
waleedelghadban	male
WaleedF	male
waleedforever2	male
waleedm	male
waleedseng	male
waleedshafy	male
Waleed.Tantawy	male
walid	male
Walid	male
Walid%20Soliman	male
walidadel	male
walid_cocaa	male
walidelsammak	unknown
walied	male
walindinho	male
Walker	male
Wanas	male
WANIS	male
Wannas	male
waool	male
WARaintOVER	male
Waseem	female
wasfy	unknown
wasseem	male
wassim	female
Wassim%20Hosny%20El-Metwally	female
watedy	female
wedian	male
weebos	female
Weeka4ever	male
Wefe2	male
wel	unknown
Wel	female
wel781	male
wela	unknown
well	male
Wello	female
Welloking	female
welly	female
wellyegy	male
Wels	male
Welzo-7	unknown
wenshawi	male
Wenta	unknown
wesa	male
wesam	unknown
Wesam	unknown
WesoWeso	unknown
wessam	unknown
wessam79	unknown
wessam.hejazy	male
wessam_mansour85	male
wessammotie	unknown
Wesusu	female
wewe	male
wgamil	male
Whalid	male
whatever	male
wHindawy	male
Whiski	male
WHTE	female
wildchild85	male
will	female
Wille	female
Willi	unknown
William	male
willo	unknown
Willy	male
wina	male
winka	unknown
wivern	female
wkasem	male
wkhalifa	male
wmehany	male
wmeno	male
Wolfman4Ever	male
Wonder	female
woody	male
worshiper	male
wsamir	male
wsma2006	female
WSS	unknown
wudds	male
wwmm	male
www	unknown
-~X~-	unknown
Xena	female
xfhvfdsffrsse	female
xm	female
Xorgacz	female
xpirate	unknown
xTimox	male
XtremeKimo	male
xxmhtx	unknown
xxx	male
xxxxtarekxxxx	unknown
Y000	male
yahia	male
Yahia	female
yahoo.com	female
Yahya	unknown
YahyaELNAHHAS	unknown
yako	female
yamosahel	male
yara	female
Yara	female
YaraMS24	female
yara.s	unknown
yaraz	unknown
yas29	female
yasmeen	unknown
yasmin	female
Yasmin	female
Yasmin%20Amr	unknown
yasmin92	unknown
yasmina	unknown
YasminCHE	unknown
yasmine	male
Yasmine	unknown
Yasmine286	unknown
yasmine30	unknown
YasmineDardery	unknown
yasminelwany	male
YasmineMahmoud	male
Yasmine.n	male
YasmineOfEgypt	male
yasminHattia	male
YasminM	male
yasminmagdy	male
Yasseen%20Yoshimura	male
yasser	male
Yasser	male
Yasser%20Alaa	male
Yasser%20Etman	male
yasserfadel	male
yasserhashem	male
YasserMagdy	male
Yassermazen	male
yasser_morsy	male
YasserNasrElDien	male
yassien	male
yassin	male
Yassin	male
yassmeen	male
Yassminghith	male
yasso	male
Yasso	female
Yasso2012	male
yasso32	male
yasso81	male
Yassoo	male
yassotiti	female
Yatti	male
yaya	unknown
Yazeed	male
yehia	male
Yehia	unknown
yehiaagiza	male
yehia_atef_kamal	unknown
yehiaramadan	unknown
Yehya..	female
Yehyak	female
y.elnaggar	male
yeso	unknown
yezzat	unknown
YGHARBAWY	male
yghozlan	male
YK	male
y.k.e	male
ykhattab	female
ykhawanky	female
YMarzouk	female
y.m.b	female
ymeid	female
yo	unknown
Yobza	female
YOKA	unknown
yokaa	male
yomna	male
Yomna%20Sassy	female
yomnaahmedgadelkarim	male
yomnaelsherif1	unknown
Yomnassar	female
yomyel-fouly	female
Yono	female
yoosef007	female
yosef	female
yosefsharaf	female
yoshka	female
yosloz	unknown
Yosr	male
Yosr%20El-Dakhs	male
yosra	female
yosra87	female
yossra	female
YOtty	male
you	male
Youans	male
youka	male
youmna	male
Youmna	female
younis	unknown
Younis	male
yousef	male
Yousef	male
yousefice	male
yousra	male
Yousra%20Eldaly	male
youssef	male
Youssef	male
Youssef124	male
Youssef2014	male
youssefabd	male
youssefawad	male
youssef_daoud	female
youssefgs	female
youssefismail10	female
YoussefologY	male
YoussefSarhan	male
youssif	male
yox	male
yoyazz	male
YoYo	unknown
yoyoyoussef	unknown
yoyzi	male
YPHA	male
YR	male
YS	female
Yshams	male
Ysrmahfouz	unknown
yssser	unknown
yumyum	unknown
yussef	female
yuyu	female
yve	female
Y.z	unknown
yzeftawy	unknown
Za3bolla	female
za7ma	male
Za7ma	male
ZA7MA	female
zaaak	male
zaafrani	male
zaara	female
z_abdelkader	unknown
Zadel	female
Zaghlool	female
Zaghloul	female
Zaher	unknown
zahma	unknown
zahow	female
zahra	male
zahraa	male
Zahraa	male
ZahraaZ	male
zahran	male
Zainab	female
Zaka	male
zakawkaw	male
zaki	female
Zaki	male
zako	female
zalouka	female
zalttttttaaaar	unknown
zamaged	male
zamalkawy	female
zamalkawy4ever	female
zamalkawyy	unknown
zamazemo	male
zamba	male
zannouba	female
Za_Real_Meezo	female
Zatates	female
zayat	female
Zayed	male
zayetsafe	male
Zaygooot	unknown
zaynab	unknown
zaytona	female
zazoooo	male
zblainz	female
ze2ro	female
zeacus	female
zeehumanbeing	female
Zeemoosh	female
ZeeRushdy	male
zeidan	unknown
zeina	female
Zeina	male
zeinab	male
Zeinab	male
zeka	male
Zekas	female
zekwa	male
zelafy	male
zenhom	unknown
zera3y	unknown
zeuss	female
zexo	male
zeyad	male
Zeyad	male
ZeyadAbouelLeil	female
zeydattalla	male
zezozezo	female
ziad	female
Ziad	male
ZIAD	male
Ziada	male
ziadawad	male
Zicoo	female
zicooooo	female
zidan	male
zika	unknown
zikaWpas	male
ziko	unknown
ziko73	male
zikomimo	unknown
zikooo911	male
zimofox	male
Zimos	female
zinab4	male
Zincoxide	male
zingooo	female
zizo	female
Zizo	female
zizo1112	male
zizo19	female
zizogamal	female
Zizooo	female
zizoooo	female
Zizoooo	male
Zoghby	male
zoka	male
zoka1982	male
ZOLDAN	male
zoma	male
ZOMA.86	male
zomba	female
zomy	male
ZooM	male
Zoom884	female
zooz	male
zooz90	male
Zorbieh	male
zoro	male
Zouzooou	female
Zoyet	female
Zoz	female
zozoezz	female
zozosu	male
zreyad	male
zshamsi	male
zuma	
Zunno	
zwbaa	
Zyad	
ZyadRamzy	
zzeineldein	
ابراهيم	
ابن	
أبو	
ابو	
ابوخطوه	
ابوعبدالله	
ابوعمر	
ابوعمرو	
ابولهب	
ابوهاله	
أحمد	
احمد	
احمد2002	
احمدعمارة	
اسامه	
أسد	
اسلام	
أفلاطون	
الاسكندر	
الاسكندراني	
الاهلى	
البذىء	
البرنس	
البهظ	
البوب	
الحكمدار	
الخواجه	
الدولي	
السفر	
السيد	
الشاذلي	
الشبكش	
الشيخ	
الطير	
العشري	
العطار	
العمده	
الغامض	
القبطان	
القرموطي	
الكبير	
الكحيت	
المخرج	
المركز	
المواردي	
الموديولوجي	
المومو	
النونو	
الهرم	
ام	
امير	
أهلاوي	
اوعى	
اونكل	
ايشوووووو	
ايمان	
أيمن	
ايمن	
باسم	
بهجت	
بوب	
بيبو	
بيدو	
بيرووو	
تامر	
تامرصلاح	
جابر	
جبري	
جمال	
جو	
جوجو	
جيمي	
حازووووومالعندليب	
حامد	
حزلئوم	
حسام	
حسان	
حسن	
حسين	
حمادة	
حماده	
حنظلة	
حنين	
خالد	
خدلك	
د/	
درش	
درويش	
ديمقراطي	
راجى	
رامي	
راويه	
رحال	
رضاحسان	
زكي	
زملكاوى	
زيزو	
سامي	
سامى	
سانتا	
سايكوباتي	
سحاب	
سعيد	
سمير	
شريف	
شقاوة	
شوارعي	
شيرى	
شيكو	
صلاح	
صهيب	
طيار	
عابر	
عادل	
عاطف	
عبد	
عبدالدايم	
عبدالرحمن	
عبدالعظيم	
عبدالغفار	
عبدالله	
عبده	
عشاق	
عصام	
علاء	
علي	
على	
علے	
عمرو	
عمو	
فاروق	
فاعل	
فراويلة	
فهمي	
فهيم	
كريم	
كمبورة	
كيمو	
لي	
مُحٓرّمْ	
محفوظ	
محمد	
محمدالبناا	
محمدمصطفى	
محمود	
محي	
مراد	
مرسي	
مسافر	
مش	
مشمش	
ملاك	
ملك	
ممدوح	
مهندس	
مودى	
مولانا	
ميخائيل	
ميدو	
ميزو	
ميكو	
نادية	
ناصر	
نسرالشرق	
نوح	
نور	
هشام	
هوبا	
هيثم	
وافي	
وائل	
وسام	
وطني	
وليد	
وليد82	
ياسر	
ياما	
يحيى	
يماني	
